44
ckj=lut+umi*yej
ece=fin/jiw/nao+njg/gqy*cvc*yej/kvq+jpu+mjk/vyb
ubt=ckj+agq-fin-lut+tej*jiw*nao/trg*gdx-gqy*ngj/lgl-cvc*onk+jpu/dqg
agq=ckj-lut+jiw/ile*njg+umi-yej*mjk+vyb
fin=lut-ile*umi*yej
mge=ckj+ece+agq+lut-sgb/nao-gdx+umi+ngj/lgl/cvc*onk*jpu+kns+vyb
dag=ckj-ece/agq/lut-sgb+tej*nao+njg+jbr/yej+onk+jpu*kns
sgb=ckj+jiw*nao*njg+gqy+umi+cvc*jpu
woj=ckj*ece/agq/sgb*tej+otf-ile/gqy/umi/ngj/cvc+jpu*mjk+mjt
jva=ckj/agq+fin/lut-sgb/ile/gqy*lgl/cvc+yej/kvq*jpu/dqg
wgd=fin*lut+sgb-ile*njg-gdx+umi+ngj+lgl/yej-kvq/jpu-mjk+dqg
tej=ile/njg*yej*mjk
yon=ckj+ece-agq*fin+sgb-tej+ile/njg+gdx*jbr+gqy*umi*ngj+yej*kvq*onk+jpu*kns+mjt/vyb
jiw=ile/njg+umi*yej+mjk
raj=ece-fin/lut*sgb*tej/nao/otf-trg*njg+umi*lgl*yej+dqg-vyb
nao=njg-umi+yej-mjk
otf=lut/jiw*ile+njg*gqy+cvc+kvq-onk-mjk
ahj=ckj*agq+fin+lut-tej+jiw/nao*ile*njg+umi/ngj-lgl/cvc+kvq-vyb
chl=ckj/ece*agq/nao/otf-jbr-cvc*yej/kvq*mjk-mjt
fru=ece/fin+sgb-tej*ile-njg*gdx-lgl*cvc/kvq+onk/jpu+kns+mjt
trg=fin*jiw+nao*njg+yej*kvq-jpu/mjk
bjs=ckj+ece-sgb/tej+jiw-nao*ile+njg/gqy*umi+lgl*cvc/yej+kvq-onk/dqg-vyb
hns=ece-jiw-nao-otf/ile-njg*gdx*gqy+umi-lgl*cvc-yej/onk-jpu/mjk/kns+mjt*vyb
mps=ckj-ece+fin*nao+otf-trg/gdx-jbr*gqy*umi*kvq*mjk*dqg+vyb
sdd=ckj+agq/sgb+tej*otf+gqy+umi-ngj*lgl-cvc/kvq*onk-jpu-mjk/mjt
gdx=ckj/fin+tej+jiw-nao/njg-gqy*umi/kvq/onk+jpu
jbr=ckj+lut*nao*umi/cvc+kvq+onk+vyb
oyl=ckj-ece*agq/lut*jiw*otf-ile+trg/njg+gdx/jbr+ngj+lgl*cvc-yej+jpu/mjt
dkn=agq*fin*sgb-jiw-nao-jbr-umi*ngj*lgl/jpu-kns+mjt+vyb
gqy=lut-njg*umi+yej
ngj=fin-lut-tej-jiw-nao-yej/kvq+onk/jpu
lgl=ckj/fin*lut*nao/ile*njg-gqy+yej+onk*jpu+mjk+vyb
cvc=ile/umi
arn=ckj/agq/fin/lut+sgb/tej/jiw+otf*njg+gdx-jbr+gqy-umi/lgl+cvc-yej*kvq/mjk*dqg
hxw=ckj-ece/agq*fin*jiw/nao+otf*jbr+gqy/ngj
kvq=ile/umi+yej-mjk
onk=ile-umi/mjk
jpu=ile+yej
ewc=ckj*fin-tej*jiw/otf*ile+jbr/gqy*kvq-mjk/dqg
kns=jiw/ile/gqy-yej
xxt=ckj-agq*lut-tej-nao/njg-gdx*gqy-umi+lgl*cvc+yej-onk/mjk-kns-mjt/dqg/vyb
mjt=ckj-jiw-nao+ile*njg/gqy/umi+cvc/jpu/mjk+vyb
dqg=ckj/fin+lut/tej*jiw-ile*umi+kvq-onk+mjk
vyb=lut/ile-umi+yej/mjk

