50
ckj=ece-fin-mge*lut-dag+woj*yon-nao-ile*fru-trg*hns+jbr*dkn-umi+ngj+arn-onk-jpu*mjk/kns-dqg
ece=ubt/agq-fin+lut/dag*sgb-woj-wgd/tej-yon-raj/otf+fru*trg*bjs+hns/mps/sdd+gdx+jbr-dkn/umi/lgl*kvq+onk+xxt
ubt=ckj+ece-agq*fin-mge+dag+sgb/jva/wgd/yon*raj*nao*otf-ile/chl/fru*trg+gdx+oyl+umi-ngj-cvc*yej*kvq/jpu/mjk+kns*xxt/dqg*vyb
agq=ckj*ubt+fin+sgb*woj+jva+tej-raj+ahj*trg*bjs+njg*gdx+jbr*oyl*dkn+gqy/umi-ngj/arn+yej*hxw-mjt
fin=ckj+agq/mge+lut-wgd-raj+nao*otf+chl-bjs+njg+hns*mps-jbr-dkn-gqy/umi*ngj+kvq*onk*jpu-mjk+xxt
mge=ubt+agq*fin*dag*sgb+woj-jva-jiw-ahj+ile*trg-mps-sdd+jbr/umi*lgl*cvc*yej*hxw*ewc/dqg-vyb
lut=sgb/woj/jva*wgd+tej-yon-jiw+nao*otf/ahj/chl+njg+sdd/gdx/jbr-oyl-dkn-gqy-lgl-arn/hxw+mjk+vyb
dag=ckj-ubt/agq+fin-mge*sgb-woj+jva*yon+jiw+raj-chl/trg*bjs+hns+jbr-dkn*umi*ngj*yej+kvq+jpu+ewc+kns/mjt+dqg
sgb=ckj*ubt/fin*woj/raj-nao*otf+ahj+ile-fru*trg*bjs*gdx*ngj-lgl/cvc/yej*hxw+kvq+jpu*xxt*dqg
woj=ubt-lut/dag+jva+wgd-yon/nao*trg/njg+hns/sdd-oyl*dkn/gqy*ngj/lgl*arn+kvq-mjk+ewc+kns/xxt/vyb
jva=ece+ubt*mge+jiw*raj/nao+ahj*ile*fru-mps+gdx-oyl-dkn+gqy+ngj/cvc/yej-kvq-onk-jpu*mjk-ewc-vyb
wgd=ece*fin+mge/sgb*woj/yon+otf/ahj*chl*fru-trg-bjs+hns/gdx-jbr+gqy-ngj-lgl*arn-yej-ewc-xxt-mjt/vyb
tej=ubt+fin*mge/sgb-woj/yon/raj*otf-hns*mps+gdx*ngj-yej/hxw-kvq/jpu-ewc*kns/vyb
yon=ckj*mge/sgb-woj+jva/tej/jiw/ahj+chl*fru+trg*njg*hns+mps*sdd-dkn-ngj*lgl+yej*hxw-kvq*mjk/xxt/mjt/dqg-vyb
jiw=ckj-ubt*agq/fin-mge*lut-dag+sgb+woj/jva/tej+nao*ahj+ile+chl-fru-trg/bjs-njg-jbr*oyl/dkn+umi+ngj-lgl/arn*onk*kns+xxt-dqg
raj=ubt-mge/wgd*tej*yon-ahj-fru-bjs/njg*hns*sdd*gdx-oyl/dkn+umi/lgl+yej*hxw+mjk-kns+xxt-dqg
nao=ece/mge/sgb-tej*yon+jiw+ahj/ile*fru*hns+sdd/dkn-gqy/umi*ngj/lgl-cvc-arn+yej*kvq-onk/ewc-kns-mjt
otf=agq/fin/lut*dag-sgb+woj*tej-yon*jiw-ahj-ile/chl/fru/njg-sdd/gdx+jbr/gqy+lgl-arn/yej*kvq-onk*mjk*kns
ahj=ckj+ece-ubt-mge-dag/sgb-wgd/yon-nao-fru+bjs/mps*gdx+oyl-dkn+ngj-lgl/cvc-kvq/onk*jpu-kns/xxt-dqg-vyb
ile=ece+ubt*agq*mge+lut/dag-sgb/jva+wgd-jiw/nao-ahj*bjs+njg-sdd*jbr*dkn-gqy-cvc+yej-onk-jpu-mjk/mjt+dqg-vyb
chl=ckj-ubt-fin-lut-woj/jva*yon*jiw-raj*nao+otf-ile/fru*trg*hns*jbr-ngj-arn-kvq+jpu*mjk+ewc-xxt/dqg
fru=agq/fin*mge/woj*tej*nao/otf/chl-hns+gdx/jbr/oyl+dkn/gqy-umi/arn+yej/hxw/onk/jpu+mjk-ewc*kns-xxt+dqg/vyb
trg=fin-lut-sgb+woj-wgd+tej/yon/jiw-raj-otf/chl-fru+njg*hns/mps*sdd-gdx+oyl-lgl*arn*yej/kvq/jpu*mjk-ewc*xxt-dqg-vyb
bjs=ckj/ubt+fin-dag-sgb/woj-yon*raj*otf-gdx+oyl-gqy+umi/ngj/cvc+yej+hxw/mjk+ewc*kns/dqg
njg=ckj/sgb*woj+wgd/tej*yon+jiw-nao+otf-ahj/ile*fru/trg*hns+mps-sdd/jbr*umi-ngj*cvc/hxw*jpu+ewc-kns/xxt*mjt
hns=ece/ubt-agq*mge*lut*sgb-woj+jva*wgd/tej+yon/jiw+raj*nao*otf/ile-trg*bjs+mps/sdd/gdx*oyl+gqy/umi/ngj*arn*hxw/kvq-ewc/xxt-mjt
mps=ckj-fin*mge+lut*dag/sgb/woj-jva/wgd*yon/jiw-raj+nao-otf+ile-chl/fru+bjs+sdd/jbr*oyl+dkn-gqy/ngj/lgl/arn+onk-ewc*mjt-dqg
sdd=agq-lut-dag/sgb-jva/tej+yon/jiw-raj*ile*chl-fru/trg*njg*hns+mps/jbr-oyl+gqy+umi+lgl-cvc/hxw*mjk*xxt+mjt
gdx=ckj*ubt-mge-lut+dag+wgd/yon-raj+nao/otf/ahj/ile*chl*hns*mps+jbr-dkn*ngj-lgl/cvc-yej*kvq+jpu-mjk/xxt+mjt*dqg
jbr=ckj+ece/agq-sgb-woj/jva+tej+jiw/nao/otf-ahj/chl+fru+bjs/njg/sdd+dkn-gqy-umi/arn*yej+hxw-kvq*ewc/dqg-vyb
oyl=ece-sgb+jva-wgd-yon*jiw-raj*ahj-ile/trg+bjs*sdd+jbr/dkn/gqy*umi*ngj/lgl+hxw/mjk+xxt-dqg-vyb
dkn=ckj-ece*mge-lut/dag/jva-nao+otf*ile-chl/mps/sdd/gdx+jbr*cvc*yej+hxw-kvq+onk+mjt+dqg/vyb
gqy=ckj/ece+ubt+agq*fin+lut*sgb*yon-jiw+raj*otf+chl+fru*hns+sdd/gdx/dkn+cvc/arn/yej-hxw-ewc*kns*mjt/dqg/vyb
umi=ubt+agq-mge+dag-sgb+woj/jva/yon*chl-trg+hns/sdd-dkn-ngj-cvc*arn+yej+onk+mjk+xxt/mjt
ngj=ckj*ubt*fin-woj-jva/wgd*yon*raj+chl+bjs+njg-mps+gdx-dkn-gqy/umi/lgl*cvc*hxw*onk*mjk-kns/xxt-mjt-dqg
lgl=agq+fin-lut-jva/wgd+jiw-otf*ahj*chl-fru/trg*bjs+njg*hns-sdd*jbr*dkn+hxw/jpu+mjt
cvc=ece+ubt*agq+fin+woj+jiw+nao-otf+bjs+hns-mps-sdd/jbr-gqy-umi*ngj+lgl/hxw*kvq-onk-mjk/ewc+kns+xxt*mjt-dqg+vyb
arn=ece+ubt*fin*sgb*wgd-tej*jiw/raj-otf/ahj+trg+bjs-njg/sdd+gdx/oyl+dkn/lgl-yej+hxw/onk+kns/dqg*vyb
yej=ubt/agq+fin/jva*wgd-tej-jiw/raj+otf*ahj*ile-chl-fru+trg/mps*gdx/oyl+umi/lgl*cvc/arn+kvq-onk*ewc*kns*xxt/mjt-dqg+vyb
hxw=ece/fin+mge*lut*jva+wgd-yon+ahj-ile-fru/bjs/hns+dkn+gqy+umi/onk/mjk-ewc+xxt*mjt+dqg-vyb
kvq=ckj*ece-lut/dag+woj-jva-wgd/jiw*nao-otf/trg/hns/gdx*dkn/umi*lgl-yej+onk*jpu*mjk-ewc/kns-xxt+mjt+dqg
onk=ckj+ubt+agq*mge+sgb+woj/jva-wgd+raj/nao+otf/ile-fru+hns+mps+sdd+gdx/oyl-dkn+ewc-kns/dqg/vyb
jpu=ckj+ece/ubt-agq-lut-jva-wgd*yon*otf/ile-fru-trg-hns/mps*sdd*jbr+oyl+dkn*umi-ngj-kns+xxt*dqg/vyb
mjk=ece-ubt+agq/mge/lut*sgb*wgd*tej*yon+jiw+nao/otf-ahj+ile+fru*trg+njg+hns*gqy/umi-lgl+cvc/yej/hxw/onk+ewc+kns-xxt
ewc=ckj/ubt*agq/fin/woj*jva+jiw/nao*ahj*chl+fru+trg+bjs+mps*sdd/jbr+dkn/umi/lgl*arn/hxw+jpu+kns-vyb
kns=ckj-ece*ubt*agq+mge*jva*tej-yon/jiw/nao/otf/ahj-ile+fru+bjs+njg+hns-mps*sdd/gdx*jbr/dkn*gqy-lgl*cvc/yej-mjk/ewc-xxt*mjt-dqg-vyb
xxt=dag+wgd+yon+raj-nao*otf+chl/fru+trg*bjs-njg/mps-gdx*gqy/umi-lgl+cvc/hxw*ewc/kns/dqg/vyb
mjt=dag/woj+jva-wgd+tej/yon*raj+chl-hns*gdx*jbr-oyl/dkn*gqy/umi/ngj+lgl-arn/yej/kvq+jpu/mjk-ewc*dqg
dqg=lut+sgb/woj*wgd+tej/jiw-nao*ile/bjs*njg-mps/gdx/jbr-oyl-dkn*gqy+umi*ngj*lgl*cvc/yej*hxw*kvq*onk*jpu/ewc-mjt*vyb
vyb=ckj/ece+ubt/fin*lut/dag/yon*raj/nao+otf+ahj-ile/sdd*gdx*ngj*lgl-arn*yej/hxw/kvq*mjk-ewc-xxt+mjt

