50
ckj=fin-mge-woj/jva*wgd*yon+jiw/raj-otf*ahj*trg-bjs*njg/hns+sdd-gdx/jbr+oyl/dkn*umi/arn/hxw+mjk/ewc*vyb
ece=ubt/fin/mge/dag*woj+jva+wgd*tej+jiw-nao+otf+ile+fru+trg-bjs/njg-mps-sdd+gdx-gqy-umi/ngj+cvc*hxw*onk/mjk-dqg/vyb
ubt=ckj*mge-lut*sgb/woj+wgd/yon-jiw+nao-otf+chl/hns+gdx*jbr+oyl*gqy+ngj+lgl*cvc+arn/kvq-onk+jpu+mjk*ewc*kns/xxt*mjt+dqg/vyb
agq=ubt/fin-mge+sgb/woj-jiw-otf+ahj*fru*trg+njg-mps/gdx-oyl-dkn/gqy/umi+cvc-arn-hxw-mjt-dqg/vyb
fin=ece-agq+lut-sgb/jva/wgd/tej-raj*nao/otf/ile/chl/fru-trg-bjs+njg-hns+sdd-jbr-oyl-umi*arn+yej-hxw-mjk/ewc/kns+xxt-mjt-vyb
mge=ece-ubt/agq/lut-dag+sgb/woj*jva-tej*yon-raj/nao-otf-ahj+ile+njg/gdx/umi*yej*hxw+kvq+mjk*mjt/vyb
lut=ece*woj*jva/wgd/tej*nao*otf+fru+trg-bjs*njg+sdd*gdx+jbr-oyl+dkn-gqy/umi/cvc/arn+yej-hxw*onk*jpu/ewc
dag=ckj*ece-fin/sgb-woj-jva-wgd/yon/nao-chl/bjs*njg*mps-sdd+jbr*oyl/gqy+umi+ngj*lgl/cvc*hxw-onk*xxt-vyb
sgb=ckj+agq*dag*woj/jva*raj+chl/fru/njg-mps/gdx-jbr-oyl-gqy+ngj-lgl-yej*kvq-jpu+mjk-ewc*kns*xxt+vyb
woj=ece/ubt+fin-mge-sgb*jva-wgd/tej+jiw*ile-trg-hns-mps+sdd-oyl/gqy*umi/ngj-cvc/arn*yej+onk*mjk+mjt
jva=ece*ubt*fin+lut+sgb-wgd+tej/yon-ahj*ile/chl-fru+njg-mps-gdx*oyl/lgl*cvc*yej*hxw/kvq*mjk-xxt/mjt/dqg+vyb
wgd=ckj*ubt-fin+lut+dag+woj+tej-yon/jiw-nao+otf/ile/fru/trg-njg/mps-sdd*gqy/cvc*arn-yej-onk-jpu/mjk/vyb
tej=ckj-ece+ubt*fin+mge-dag-sgb*jva-wgd*jiw-otf-ile*chl-bjs-njg*hns+jbr+oyl-gqy/umi/cvc-arn+hxw/onk-jpu/mjk/kns+dqg/vyb
yon=agq*mge+lut+woj*jva/wgd*jiw+nao-ahj/trg/njg*sdd+gdx*jbr*gqy+ngj+lgl-mjk+ewc/kns+mjt*dqg
jiw=ckj+ece/ubt/agq+lut+dag-woj*wgd+ahj+ile+chl*trg*bjs/njg/hns/gdx/jbr+oyl/umi-ngj/lgl+hxw-kvq*jpu/kns/xxt
raj=ckj+ece+agq/fin-mge+lut+dag/woj*tej+otf-ahj+ile*trg-bjs-sdd+gdx/gqy+umi+ngj-cvc-hxw+kvq/onk/mjk*ewc*mjt-vyb
nao=ckj+agq+fin*mge-lut*dag-wgd*jiw*raj/ahj/chl-trg/bjs*njg-mps-sdd*gdx-gqy+umi/ngj/lgl+cvc-onk-jpu/mjk-ewc-xxt*dqg/vyb
otf=fin-woj*jva*tej*raj-ahj/chl+fru-bjs/njg*sdd*gdx*jbr/oyl/dkn-gqy-umi+ngj*arn/yej+kns*xxt-mjt+dqg-vyb
ahj=ckj+fin-sgb*woj-tej*yon+jiw+otf+chl/hns-gdx/umi*lgl/cvc-yej-kvq-onk+jpu/mjk/dqg/vyb
ile=ckj*agq*mge*lut+dag/sgb*woj*jva*yon-raj-nao*otf/chl-bjs*hns/gdx+dkn-umi+ngj+arn/yej-jpu*kns/dqg
chl=ece+ubt-agq+lut+woj+jva*wgd-yon+jiw-otf-gdx+jbr-gqy+ngj*lgl*arn*yej+mjk/ewc*dqg*vyb
fru=ckj-ece+agq+mge*lut*sgb*jva/jiw-nao+otf/chl-mps+sdd*gdx-cvc+arn+hxw-onk-jpu/mjk+mjt*dqg+vyb
trg=ece*fin/mge-lut*sgb/woj+jva-yon/jiw*ahj*ile*chl/bjs+mps/gdx+gqy*umi+lgl*arn-yej/jpu*kns-xxt+mjt*dqg-vyb
bjs=ubt+sgb/jva*wgd-nao*ahj*ile-chl*fru/trg-hns+mps*sdd*gdx*jbr-oyl*dkn+gqy/ngj-kvq/onk*ewc+dqg*vyb
njg=agq/fin-lut+jva/wgd+tej+ahj-ile/chl/trg*bjs+mps*gqy*umi*ngj+cvc/hxw-onk/ewc*mjt-dqg+vyb
hns=ece-agq/mge+woj-jva*wgd+tej*jiw-raj+ahj*ile+fru+trg+njg/gdx*jbr*oyl-gqy-umi+ngj-arn-yej*jpu-mjk-kns*xxt-dqg*vyb
mps=ece/fin-lut*sgb*yon+raj-fru-trg+hns+sdd+gqy*umi/cvc+kvq*onk+kns/xxt*mjt-dqg/vyb
sdd=ece-ubt-agq+fin-lut+sgb*woj/raj+nao/ahj/chl+trg/jbr/oyl+umi+ngj+lgl-arn-yej+hxw+onk+jpu+mjk+kns/xxt+mjt
gdx=ece*ubt*mge-lut+dag/woj*jva*wgd*tej+yon*jiw*ile-mps/sdd-jbr-dkn/cvc-arn*hxw-onk*jpu-mjk-kns*vyb
jbr=ckj-ece*ubt-fin/mge/lut*dag*wgd-raj+ahj/ile-chl+trg/bjs-hns-gdx/dkn+ngj+lgl+cvc+hxw/kvq-jpu*ewc-xxt/mjt*vyb
oyl=agq*mge-sgb*jva+wgd+tej-yon+jiw-raj-ahj*chl/fru+bjs+njg*hns-sdd/dkn-gqy*arn-hxw-kvq/onk*jpu/ewc*kns*mjt/vyb
dkn=ckj*ece/fin-woj*wgd+raj+nao*ahj/fru-njg-hns*sdd+gdx*jbr/oyl/lgl+yej*hxw+kvq*onk*mjk-ewc*xxt
gqy=ckj+ubt+agq*lut+dag/sgb-woj-jva+wgd+tej+yon+nao/otf/ahj*ile*trg*bjs+mps*gdx+oyl+dkn*arn*yej+hxw-onk/mjk-xxt/vyb
umi=fin/mge*tej/yon*ile+njg+hns+mps+ngj*lgl-hxw*jpu*ewc+kns*xxt-mjt
ngj=agq/sgb*jva*tej/yon*jiw/raj+ahj+ile/chl/hns-oyl+dkn*gqy/umi*hxw+kvq/onk/mjk+mjt+dqg
lgl=ckj*ece/agq+jva-wgd/tej-yon*raj*ile-fru+trg+bjs/hns/mps-sdd*gdx+dkn+umi*yej*onk+jpu+ewc/kns*dqg
cvc=ece-ubt/fin+mge+lut*dag+sgb/woj+wgd-yon*otf/ile*fru-trg+mps/oyl+dkn*gqy-umi+hxw/jpu/ewc/kns+xxt*vyb
arn=ckj+ubt*agq*fin/mge-dag+woj*wgd*tej-yon*nao-otf+fru*mps-sdd+dkn+umi-lgl*cvc*kvq-onk/ewc-kns/xxt-vyb
yej=ubt/mge*dag+tej-yon+jiw/mps/sdd-gdx+jbr/umi+cvc-mjk*mjt*dqg
hxw=ckj*ece-ubt-agq+fin/woj*jva/wgd/tej*raj*nao-ahj+ile*njg-hns/mps+sdd/oyl*lgl-yej/onk/jpu*kns/mjt
kvq=ckj-fin-lut/dag-sgb*tej-jiw/otf-ile-fru*bjs*hns-sdd+gdx+oyl*dkn*umi/lgl*cvc-hxw*onk/jpu+ewc-kns*dqg
onk=ckj-ece+woj+wgd-yon+raj+otf-ile*fru-trg+bjs*hns*mps*sdd+jbr/oyl-dkn+gqy/umi/cvc+yej/xxt-dqg
jpu=ckj*agq/lut+sgb/woj-jva*otf-ile/chl*hns/sdd/jbr/oyl/dkn+lgl/cvc/kvq*mjk-ewc+kns/mjt
mjk=ckj-mge-lut/woj*jva/wgd/tej/yon*nao-ahj-trg/njg+gdx/dkn*gqy-arn-onk-jpu*ewc*mjt*vyb
ewc=ckj+ubt/agq+mge+jva*tej-nao+otf*ahj-ile*fru-njg+oyl/dkn+gqy-ngj*lgl/arn-yej*hxw*onk/mjk*kns*mjt
kns=ckj*ece*agq/lut+woj/wgd+tej+yon-jiw+raj+nao-hns-sdd*gdx/jbr/dkn+cvc/arn/yej-mjk/xxt-dqg+vyb
xxt=ckj*ece+dag-sgb*jva-yon+raj/nao/otf/ahj-chl-fru+bjs*njg*mps+sdd*gdx*gqy/umi/ngj*lgl*arn/ewc*kns/mjt/dqg
mjt=ece/mge-sgb/wgd*jiw+raj/nao+ile*fru-trg-njg*hns/sdd+oyl-dkn+gqy*lgl*cvc*arn/yej/hxw+kvq*onk/jpu-mjk-kns*xxt
dqg=ckj/lut+dag-jva+raj+otf/ile+trg*hns*gqy+umi/ngj/lgl*cvc*yej-hxw-mjk/mjt*vyb
vyb=agq-fin+lut/dag+sgb*woj-tej*raj/otf/fru/trg/bjs+hns/gdx*oyl*gqy-umi-lgl-hxw-jpu/mjk+ewc*kns*dqg

