50
ckj=ece+ubt+agq*lut*sgb/jva+jiw*raj-otf-ahj/fru/gdx+jbr/gqy*umi-lgl-arn-kvq+onk+ewc-kns*dqg
ece=ubt/lut/wgd/yon*jiw/raj/ahj/chl*hns+mps*sdd+gdx/jbr*gqy+arn+hxw/onk+kns
ubt=ckj+ece-agq*dag*tej+yon+otf-ahj+ile+fru+trg*bjs*hns*mps*sdd+gdx/jbr+oyl/dkn*gqy*lgl-arn*yej/hxw/jpu*dqg
agq=ece/ubt-fin*lut+dag-wgd-jiw-otf+ahj+fru*njg*hns-gdx/oyl*kvq/onk*jpu*ewc-kns*xxt+mjt-dqg+vyb
fin=ece+mge-lut*raj/nao*mps*sdd*gdx-jbr-oyl*gqy/ngj*arn+hxw+onk/jpu*kns+mjt/dqg
mge=agq-lut-dag-woj-jva-tej*yon+jiw+raj-nao+otf*fru-bjs/gdx/oyl+dkn-lgl/cvc+arn*yej+kvq-onk-jpu-mjk-ewc+kns-vyb
lut=ckj-ece/fin/mge-dag/woj*jva+yon-jiw*raj/otf/chl*bjs*mps+gdx-oyl/umi-lgl+cvc-yej-hxw-kvq-jpu/mjk+ewc+kns-xxt*mjt
dag=agq/fin/mge/lut*sgb/wgd-tej*jiw+raj+otf*trg*bjs-njg/hns+gdx/jbr-oyl+dkn-ngj+arn*hxw+onk*jpu*kns+xxt
sgb=mge*jva/wgd-tej+yon+ile-trg-bjs/hns+mps/oyl*gqy-umi-lgl+hxw/kvq+onk+jpu+kns/xxt*dqg
woj=ckj+ubt/agq-mge+lut+sgb+wgd/jiw+raj-otf/trg*hns-gdx*oyl*dkn+umi-ngj+lgl/cvc*arn-yej+onk+kns+xxt+dqg+vyb
jva=ece/fin+mge+lut/sgb-wgd+tej+yon+otf-ahj/ile/chl/fru-bjs*mps+gdx+jbr-oyl/umi+ngj+lgl+cvc*arn-yej*hxw*kvq-jpu-mjk*ewc-kns+xxt+dqg+vyb
wgd=ckj*dag/sgb/woj-jva/yon/ile*chl/njg+mps*gdx/jbr+dkn+gqy+umi+lgl-cvc-arn/yej*hxw*onk/ewc+kns-xxt/mjt*dqg/vyb
tej=ckj-fin+sgb*woj/wgd/yon-ahj-fru-trg+mps*gdx+jbr/lgl-cvc*arn/onk-ewc*kns*mjt-dqg*vyb
yon=mge-lut*sgb+jiw/otf-ahj-bjs/njg+gdx/oyl+gqy*ngj/kvq-onk+jpu+mjk
jiw=ckj/ece*ubt+fin/mge-dag*sgb+woj*jva/tej+raj-nao+otf+chl-fru*bjs+mps/gdx+jbr+dkn-gqy+umi-lgl-cvc+hxw-kvq+jpu-mjk-mjt*dqg/vyb
raj=ckj+ubt+mge+wgd*tej*otf+ahj-chl/fru+trg+hns-jbr+oyl+dkn-umi*ngj*cvc+onk+vyb
nao=ece*agq-lut*dag+sgb-woj+jva/tej+jiw/raj/ile-chl-bjs+hns-sdd-gdx+jbr*dkn*lgl/cvc/arn-hxw*onk-jpu/kns-xxt/mjt
otf=ckj/ece/mge+lut*jva*wgd-yon/raj/trg+bjs/njg-sdd-gdx*oyl*lgl+arn-yej*kvq+kns*xxt+mjt
ahj=ece*fin*lut/dag+woj*yon-raj-otf-ile/chl-trg*hns-mps*sdd/dkn-umi/ngj-lgl/yej*kvq+onk/jpu*mjk*kns+mjt+vyb
ile=agq*fin-mge+lut/dag+sgb-woj+nao/chl-bjs*mps/gdx-jbr+oyl*dkn*gqy/ngj*lgl*arn+yej+hxw*kvq-jpu*mjk-ewc+xxt/dqg
chl=ckj-ece+agq*lut/dag/sgb/woj*jva-wgd-tej-yon-otf*ile/fru-trg-mps-gdx+jbr*oyl+dkn*gqy*ngj*lgl-cvc/yej*kvq/onk/jpu/mjk*mjt-dqg-vyb
fru=dag/sgb+yon-jiw+raj/nao/otf/ahj-ile*trg/mps+sdd*gdx*jbr/oyl*dkn/gqy+umi/ngj/lgl*cvc+yej*jpu+mjk-ewc+kns*xxt*mjt-vyb
trg=ckj+agq-fin+mge+jva+wgd*yon+jiw/raj-nao+otf+ile+fru/bjs+njg/hns-dkn+gqy*umi-ngj*arn*hxw+onk*kns*mjt-dqg
bjs=fin+sgb*jva+wgd*yon*jiw/raj*nao/otf*ahj/ile*hns+oyl*gqy-ngj*hxw/kvq*onk/kns+mjt
njg=ubt+agq/fin*mge-dag-sgb-woj/jva/yon*raj*otf+chl*fru/trg/bjs/hns+mps-sdd/gdx-dkn+gqy*lgl+cvc/arn-onk-mjk*xxt*vyb
hns=ece+ubt+lut-dag*raj+otf+ahj*chl+fru/trg+njg+mps/sdd/gdx*jbr/oyl-dkn*umi-lgl/arn-hxw+kvq*jpu/mjk-ewc-kns-xxt/vyb
mps=ckj*ece/ubt/fin+mge*dag/sgb-ahj-ile*fru+trg/njg*hns+gdx-jbr/dkn+gqy*lgl+cvc/hxw/onk*ewc-kns/xxt/mjt*dqg
sdd=ece*ubt-agq+mge*dag*jva/jiw*raj+nao-otf-ahj*ile+chl-bjs+mps-jbr/dkn*arn*yej*kvq-ewc-kns-mjt*vyb
gdx=ckj*ece+mge/dag*woj*jiw/raj+otf-chl*bjs+hns*gqy+umi+lgl*cvc/arn/yej-hxw-kvq-onk/jpu/ewc-kns*dqg
jbr=ckj/ubt-agq*mge-woj/jva/tej/otf+ahj*ile*chl*fru+bjs/njg-hns/mps/gdx*dkn*gqy+lgl/cvc*arn*kvq-onk/ewc+mjt
oyl=ckj/ece/ubt+fin-mge/lut+woj*yon*raj/nao-ahj/ile-fru/trg+bjs/mps-jbr-gqy/umi+ngj+hxw*jpu+ewc+dqg-vyb
dkn=ckj/agq+mge*lut*sgb*woj-nao-trg*hns/mps+jbr-oyl/gqy/lgl/yej+hxw-onk/mjk-ewc-xxt-mjt-dqg/vyb
gqy=ckj/ece-ubt/fin/mge*lut*dag/sgb+woj+jva/wgd/tej*yon-jiw*raj+nao-ahj*chl/fru+mps+sdd*gdx/oyl+lgl/yej+hxw/onk*mjk-mjt-vyb
umi=ubt+agq*fin+mge*dag+sgb*jva/tej-raj/nao-otf-chl*fru+trg+njg/mps+sdd+gdx/jbr/dkn-gqy/ngj-lgl+arn/hxw/kvq+jpu-kns+vyb
ngj=ckj+ece+fin*lut*dag-sgb-woj/jva-raj-nao-otf/trg+njg*mps+sdd+gdx-oyl*gqy*cvc*arn*yej-hxw-onk/jpu*ewc/kns/xxt*mjt/dqg
lgl=agq+mge/lut/wgd*tej*yon+jiw-raj/nao/ile+trg*bjs+jbr-cvc*arn+yej*hxw*onk/jpu/mjk-kns*dqg*vyb
cvc=ece/ubt+mge/lut+dag*sgb*woj/wgd*raj-nao-ahj*ile+fru-trg-njg-hns-mps/gdx*jbr/dkn/umi*arn*jpu*mjk*ewc+kns/xxt/mjt
arn=ece-ubt*mge+lut-sgb+woj+jva+wgd*tej/nao/chl+fru/trg*bjs-njg/sdd*oyl*ngj*lgl+hxw*mjt/vyb
yej=ckj/ece*fin*lut+dag+jva*wgd+tej*jiw*nao*ile+chl-fru+trg-hns+jbr/oyl/dkn-gqy+lgl-cvc*kvq-mjk+mjt*vyb
hxw=ece+agq+fin-mge/lut/jva+jiw-raj*otf-ahj/ile*chl/trg*bjs/sdd+jbr*dkn*gqy-umi-ngj-cvc*arn-yej*kvq-onk*jpu/kns/xxt
kvq=ece/fin-lut*dag+sgb+yon/nao*chl*fru-njg-hns/gdx*jbr*dkn/umi+ngj+lgl-arn/yej-hxw*onk*jpu/mjk-xxt*mjt*dqg-vyb
onk=ckj-agq-mge-dag-wgd/tej+yon-nao-otf-fru/trg+njg/mps*gdx+dkn+umi/ngj*lgl/cvc*arn-jpu+ewc*kns*mjt+dqg
jpu=mge/lut+jva+wgd*yon-nao-otf-ahj-chl+fru+bjs*njg*hns/mps*oyl-gqy+ngj/arn+mjk-ewc+mjt*dqg+vyb
mjk=ckj+agq+lut+yon-nao/otf*ile-chl/bjs/hns*mps*gdx+jbr/oyl*umi+lgl+cvc*hxw-kvq*kns
ewc=ubt-agq/fin*mge*lut-dag/sgb+woj*jva*wgd/tej/ahj/fru-hns*sdd-dkn+gqy*cvc*arn*yej*kvq-jpu+mjk/xxt
kns=ubt-agq*dag-sgb/jva/otf+ahj+bjs+njg+hns/mps-sdd*oyl-dkn-umi+jpu+mjt
xxt=ckj/ece-agq+lut-jva*wgd/tej*jiw*raj/otf-ahj+ile-chl*fru/trg*bjs/njg/hns-mps+sdd/gdx*jbr+dkn/gqy-lgl/cvc+yej-hxw*kns/vyb
mjt=ece/ubt*fin-mge/lut*jva+wgd*tej+yon+nao/chl+fru*mps+sdd/gdx-jbr/oyl-umi-ngj/cvc+arn-yej/kvq-ewc*xxt/dqg
dqg=ece-ubt+fin/lut-dag-tej+yon+jiw+nao/ahj-ile+chl*trg+hns-mps/sdd*gdx+jbr-dkn-gqy*umi/lgl*onk*jpu*ewc+xxt+mjt-vyb
vyb=ece-agq-sgb+jva+tej*yon*jiw-raj+ahj/ile/chl/hns-mps-sdd+gdx/oyl+dkn-gqy/umi+ngj/lgl-yej-hxw*onk-jpu/mjk-ewc*kns+dqg

