35
fin=ckj+ece*ubt*agq+dag+sgb-trg*ngj-arn
mge=ckj+agq/fin-lut/dag+sgb*jiw/nao*ile/trg*bjs-mps-gdx/dkn/umi/cvc/jpu-vyb
woj=ece+agq-lut+jiw/nao-otf-ile/fru/dkn+ngj+arn+jpu+ewc/xxt-vyb
jva=ckj+ubt/agq-lut/dag/sgb+jiw-nao-ile/trg-bjs-gdx/jbr*dkn*umi*ngj/arn/onk-jpu*ewc-vyb
wgd=ckj*ece-ubt+fin*dag+sgb/jiw*nao+otf+ile*fru/gdx-jbr/dkn-cvc*arn/jpu
tej=fin*lut-sgb-jiw+nao-otf-gdx+dkn*umi/ngj+onk-ewc/mjt
yon=agq*jiw/nao*ile+bjs/mps+gdx/jbr*dkn*ngj-cvc/onk*jpu+ewc
jiw=ece-ubt+agq+dag/fru-trg*mps/gdx+ngj+arn/xxt
raj=ubt*agq+sgb+jiw/otf+ile/fru/bjs+dkn-ngj/cvc*vyb
nao=lut-ngj*lgl
otf=ckj+ece/ubt*lut+dag-sgb-mps+gdx/arn
ahj=ckj/ubt*agq+fin+lut+dag-sgb/otf/ile/fru-trg+umi/ngj-cvc*jpu/ewc/vyb
ile=ece-ubt/agq-fru*lgl
chl=agq-sgb-otf*fru*mps+jbr/dkn/umi-lgl+cvc/onk-ewc/xxt/mjt*vyb
bjs=ece*ubt/agq*fru-trg-ngj/lgl*arn*xxt
njg=ckj+ubt/lut-dag-sgb+nao/otf/ile/mps/umi/ngj+lgl+cvc*jpu+xxt/mjt-vyb
hns=ckj*ece-ubt+bjs+mps-gdx+jbr+umi-lgl+cvc/arn-onk+jpu-ewc-vyb
sdd=ckj-agq*dag+sgb-jiw-nao-otf/ile*fru/trg-bjs/gdx/arn-ewc*vyb
jbr=ece+ubt/dag-sgb*lgl+arn+xxt
oyl=ece+agq+lut+sgb/jiw/nao/otf/trg+mps*gdx*jbr/dkn*umi+arn*jpu-ewc+xxt/mjt
dkn=ece*lut*dag-sgb-trg/ngj/lgl
gqy=ubt*agq+fin/sgb+jiw*fru+umi-ngj-lgl+cvc-jpu+ewc-xxt*mjt
umi=ckj/ece*lut/dag/fru-mps*xxt
cvc=ece*ubt/agq/sgb-fru/lgl
yej=ece*agq*fin*nao/ile/bjs-mps-jbr*dkn*umi*lgl+arn-ewc/xxt/vyb
hxw=ckj/ece/ubt-agq+lut+dag/nao/otf*trg-jbr-cvc+jpu+xxt-vyb
kvq=ckj+ece-lut-jiw*otf+fru/jbr*umi/onk*jpu+vyb
onk=ckj*ece-ubt/agq+lut-dag+gdx/ngj
jpu=ckj+ubt+agq+lut*fru+trg*ngj*xxt
mjk=ckj+lut+dag-sgb-jiw+ile+mps/gdx/jbr*ngj*arn*jpu-xxt/vyb
ewc=ckj*ece*ubt/agq+dag+sgb/fru+mps+gdx/ngj/lgl+xxt
kns=ckj+ubt-lut+jiw/nao/ile*trg*cvc/onk/jpu*vyb
mjt=ckj/agq/lgl/arn*xxt
dqg=ece/ubt*agq+fin+lut-dag-sgb+jiw/otf-trg-mps*gdx-jbr/umi/ngj+arn-onk*ewc+mjt
vyb=ckj+ece+lut*sgb/lgl/xxt

