50
ckj=ece/agq*fin-dag/sgb*jva-yon/jiw-nao/njg*hns/sdd+gdx+oyl+dkn-arn-yej+hxw+ewc*kns*mjt
ece=fin-mge/lut+dag/woj+jva/wgd-jiw*nao-chl+fru-hns+mps/sdd*oyl+lgl/cvc/arn*kvq/jpu-mjk*ewc+kns/xxt/dqg
ubt=ckj+ece*fin+mge+sgb/woj+jva*wgd+tej+raj-otf*chl-fru*trg+bjs*hns-mps*sdd-gdx-jbr+gqy+umi/ngj/cvc+arn*hxw+jpu-mjk+ewc/kns-xxt*mjt+dqg*vyb
agq=ubt-mge-lut+sgb+woj*jva*wgd-tej-yon-otf-ile*chl/bjs/hns-sdd*gdx/jbr/dkn/gqy+umi+cvc/yej+onk*mjk/dqg/vyb
fin=ckj-mge+woj*yon+raj/nao-ahj-ile/chl+fru*njg/hns/gdx/oyl/dkn/lgl+yej-mjk*vyb
mge=ckj+agq*lut+woj/jva+jiw/raj/otf/ahj-ile-trg/bjs-njg*hns*gqy-ngj+cvc*yej/kvq*onk/mjk+ewc-kns-mjt
lut=ece/sgb-jva*otf-ahj-ile+njg/hns-jbr+dkn+umi+ngj-lgl*hxw/kns*xxt/mjt-dqg
dag=ckj-agq*fin/lut+woj+jiw+nao/otf*chl*mps*sdd+jbr/arn+kvq/onk*jpu-kns*dqg-vyb
sgb=ubt-dag-woj-wgd-tej/jiw-otf*chl*bjs/njg*hns+sdd*gdx+jbr+dkn-gqy/umi+cvc/yej+mjk-ewc+xxt/mjt
woj=ece-ubt-agq/fin/dag-tej/raj/otf+ahj/chl-trg-njg+hns/mps*oyl+umi/ngj*lgl/cvc-arn-hxw/onk+jpu+mjk+ewc*kns*xxt
jva=ece+fin*mge+wgd-tej+otf*ile/sdd+oyl+dkn/gqy-ngj-lgl*cvc-yej*kvq*jpu-kns/xxt+dqg
wgd=ckj*ece/ubt+agq*fin*mge/lut-sgb-woj/jva-tej*yon*otf-ahj-ile/chl+fru+bjs/njg/hns/sdd/gdx-dkn-gqy/ngj*arn/yej/kvq*jpu/mjk-xxt-dqg*vyb
tej=ece-ubt-agq-mge-dag-woj-jva+wgd+jiw+raj/nao-fru-trg/bjs/hns+mps+sdd-gdx+jbr/dkn/umi-ngj+arn*yej*kvq-onk-jpu/kns/mjt
yon=lut*sgb/wgd+tej-jiw-raj/nao+ahj*chl+fru/trg-njg*gdx+umi/ngj/hxw*jpu+ewc-kns*dqg+vyb
jiw=ckj/ece-ubt*agq+fin/lut/woj-jva+tej*ahj*trg-bjs-sdd-gdx/jbr-oyl/umi-arn-jpu-mjt+dqg
raj=ece+ubt*fin/mge*lut/dag-wgd+yon-jiw+fru*bjs/mps*oyl+ngj*hxw/jpu-mjk-ewc-kns*xxt-mjt
nao=ece+ubt/fin/mge-lut-dag/wgd-jiw-raj/ile+sdd+gqy+ngj+lgl*cvc+arn*kvq+ewc*xxt/vyb
otf=ece-ubt-agq+fin/mge/lut+dag*sgb+woj-wgd/tej+yon-raj*nao/ahj/fru*sdd/jbr-oyl*gqy/cvc+hxw*kvq*jpu+mjk+xxt-mjt
ahj=ubt/agq-lut/dag*sgb-woj+jva/tej*yon/raj/ile*chl*fru/trg*njg+mps/sdd*oyl+dkn/gqy-ngj-lgl*cvc-arn-yej/hxw/kvq-onk*jpu/mjk-vyb
ile=fin/lut/jva+wgd-tej/yon/otf-ahj+bjs+mps*jbr+oyl+gqy+lgl*cvc/arn+yej/hxw+onk/jpu*mjk-kns+xxt+vyb
chl=mge+lut/sgb/woj+jva*yon*nao*fru-bjs+hns/sdd*jbr/oyl/ngj/hxw-kvq*mjk/dqg
fru=ckj+ece-ubt-fin/lut-dag/wgd*yon*jiw-raj+otf-ile+gdx-dkn+lgl/arn-kvq+onk/jpu/mjk*ewc-mjt-vyb
trg=ece-ubt/fin*mge-lut-wgd-tej*yon-nao+otf/chl/hns*gdx+dkn-umi*ngj+arn-yej-kvq+jpu*mjk*ewc/xxt-mjt*vyb
bjs=ece/ubt+agq-mge-woj-jva*tej+yon+raj*otf-ahj/ile-chl-njg/hns/mps/jbr-gqy+ngj*lgl-arn*onk
njg=ckj+ubt/lut-sgb+woj*jva+jiw*nao-otf+fru+sdd-gdx-jbr*oyl+dkn/lgl/cvc-yej+onk*jpu-mjk/kns-xxt/vyb
hns=ckj+agq+fin*mge*jva+wgd-tej/yon+raj/otf-ahj*trg+njg*mps-sdd/jbr*gqy-umi-ngj-lgl/arn-yej/hxw+kvq/jpu/dqg-vyb
mps=ckj/ubt/agq*fin-mge*lut*sgb-jva-tej*jiw+raj*nao/chl/fru+trg+bjs*hns+jbr/dkn+umi-ngj*lgl-cvc+arn/onk-jpu+mjk+kns+mjt/dqg-vyb
sdd=ckj+ece-fin+sgb/woj+jva+tej+yon/jiw/otf-ile*trg/bjs*njg-hns*gdx+oyl-lgl*cvc*arn*yej+hxw*kvq*onk*mjk+kns-xxt
gdx=agq/fin+mge/sgb+woj-wgd/tej+yon+nao/otf/ile/fru/trg/bjs+hns+mps+sdd-ngj/lgl*cvc*arn+onk-ewc+xxt*mjt
jbr=ckj-ece+ubt+agq+fin/mge*lut+dag/woj+wgd/tej/yon-raj/nao/ahj+trg+hns*sdd+gdx+dkn/gqy/umi-ngj/arn/yej*kvq/kns*mjt
oyl=ckj+ece+agq*fin/mge*dag*sgb*jva-wgd*tej*jiw+raj*otf-ahj+bjs+njg/hns/gqy+umi-ngj/lgl*cvc/arn-yej/hxw+kvq+onk/jpu-mjk*ewc+xxt-vyb
dkn=ckj-ubt+agq+lut+dag+sgb/woj/wgd*tej*yon*jiw-chl+trg+njg/hns+sdd*lgl/cvc-arn-yej*hxw/onk+mjk-kns+mjt+dqg+vyb
gqy=ece*ubt/agq*fin+mge/sgb/wgd-nao-otf-chl/fru+trg*njg*mps*sdd-gdx+jbr/oyl+ngj-arn+kvq-onk+jpu/kns
umi=ece*fin+wgd*yon+raj*otf/njg-mps*gdx/oyl/gqy-ngj/cvc/arn/onk/vyb
ngj=ckj+dag*sgb/jva/yon-jiw-raj-otf+ahj+ile+bjs+sdd/gdx-jbr/oyl+gqy/umi/cvc*yej/hxw*kvq/onk*jpu*dqg
lgl=ckj/ece*ubt*fin+mge+jva-tej*yon*jiw-mps+jbr-umi/ngj/yej-jpu*ewc/xxt-mjt/dqg+vyb
cvc=fin+mge-lut/dag/sgb+woj/wgd+tej*jiw+raj+nao/fru/trg-sdd*gdx*jbr*dkn+ngj-lgl+yej/hxw/kvq+onk-jpu-mjk+ewc*kns*xxt*vyb
arn=ckj/ece*ubt+fin+dag*sgb+woj*jva+wgd-tej*jiw+raj/ahj/trg/sdd*gdx/dkn+gqy*cvc-yej/hxw+jpu-kns*mjt-dqg
yej=ece+fin*dag*jva*tej+raj*ahj-ile/chl*fru-bjs*njg/hns*mps+ngj*lgl-cvc*arn-hxw/kvq*jpu*mjt
hxw=ece+agq*fin-dag-woj-jva*wgd*yon+nao*otf/chl-trg*njg-hns-mps+dkn*lgl*arn-onk+jpu*mjk-ewc+mjt*dqg-vyb
kvq=ece*fin-mge/sgb-woj+jva/wgd+raj+ahj/ile-bjs+njg*mps-sdd+gdx+jbr+gqy*umi+arn/hxw*jpu+mjk/mjt+dqg
onk=ckj*ece-ubt+fin*lut/wgd+yon/raj+otf/chl*fru-trg+bjs+njg+hns-mps+jbr/dkn/gqy/umi+hxw+kvq/jpu+xxt-mjt*vyb
jpu=ece+ubt+agq-lut/dag-woj-yon+raj/ahj-ile-chl*hns/mps*sdd/gdx/cvc+kvq+onk-mjk/mjt*vyb
mjk=ckj-lut*tej+yon/jiw-ahj+ile+chl*fru-trg*bjs/njg/sdd+gdx-oyl*dkn/umi-lgl*cvc-yej-hxw-kvq+jpu*ewc/kns
ewc=agq-lut*dag*yon-ahj/ile/fru/trg+bjs*hns+sdd*jbr+oyl/dkn*gqy-umi+ngj/lgl+cvc*kvq-kns*xxt-mjt-dqg
kns=ece-ubt*agq-fin+mge+lut-woj-jva+wgd+yon-raj+otf+ahj/chl/fru-trg-njg*jbr-hxw/kvq/onk-jpu/mjk+ewc-mjt
xxt=ece+ubt*agq+fin+dag-sgb-jva+raj*ahj/hns-mps/gdx/jbr/umi-ngj/lgl/cvc+hxw/kvq+mjk*ewc/dqg
mjt=ckj*ubt/fin+lut+sgb/woj/jva-wgd/tej/otf+ile/trg*hns*sdd/gdx/dkn*ngj/cvc*arn+onk/xxt-dqg
dqg=ubt/fin-mge+lut-sgb-tej-yon*jiw-nao+ahj+trg+njg*hns/gdx+jbr/lgl/arn-kvq+ewc*xxt/mjt
vyb=ece*ubt*agq-fin*mge+lut-dag*sgb-woj/wgd/tej+yon*jiw+nao*ile+fru-trg*bjs*gdx*jbr-gqy/kvq/onk/mjt

