41
ckj=ubt-sgb/raj*ile/bjs*umi+cvc/arn*jpu
ece=mge-sgb-wgd-bjs/mps+umi*ngj-cvc-jpu-ewc
ubt=bjs/mps-sdd/jbr
agq=mge/wgd-raj-ahj+bjs+mps-gqy/umi+cvc*arn+jpu
fin=sgb/wgd+ahj/ile+mps/sdd*jbr/umi*ngj/cvc/arn*jpu
mge=wgd-bjs-jbr-ngj
lut=ubt-wgd/ahj/bjs/mps+gqy/umi*ngj/arn*ewc
dag=ckj-ece/ubt/agq-mge+sgb-wgd+tej/jiw+ahj+ile+trg*bjs-njg+hns+jbr*gqy*ngj+cvc*yej*hxw*jpu/kns-xxt
sgb=ahj*bjs+sdd+jpu
woj=mge/wgd*ahj-ile+mps+sdd/ngj-arn
jva=raj-bjs/gqy-ngj*arn
tej=mge+sgb*ile/ngj*jpu
yon=mge/wgd*ahj*ile-mps+sdd-jbr+umi+cvc/ewc
jiw=mge-sgb/ahj*bjs*jbr-gqy+umi*ngj+arn*jpu/ewc
raj=wgd-ahj/mps+jbr*umi
nao=mge+mps-jbr*gqy+cvc-arn/jpu-ewc
otf=ece-agq+lut/sgb*tej*jiw+nao-trg*njg/hns+jbr+oyl+umi*hxw+kvq+jpu-vyb
ile=wgd/bjs*sdd/jbr*jpu
chl=ckj*ece*ubt+agq+fin*lut+sgb+woj-wgd/tej+yon+nao*ahj+mps-jbr*oyl+cvc+hxw+ewc*xxt-vyb
fru=ckj*ece*ubt*agq*lut/sgb-woj+jva-yon/nao*njg-sdd*gqy-ngj-arn*yej*kvq/jpu-xxt/mjt
trg=ubt-wgd*ahj-ile+bjs+sdd/jbr+gqy-ngj+ewc
njg=ubt/mge*ahj*ile*mps+jbr/ewc
hns=ubt+mge+ahj/bjs*mps-sdd+jbr*umi/ngj*arn*jpu/ewc
gdx=ckj-agq/lut-sgb*woj/wgd*tej*jiw/ahj/ile-njg*hns*cvc/kvq/kns+mjt
oyl=ubt/wgd*raj*ahj-ile/bjs+umi*ngj*arn
dkn=ckj-sgb*yon+jiw*nao/trg+hns+sdd/jbr+oyl-hxw-jpu+kns/vyb
gqy=mps/sdd+umi+ngj
lgl=ckj+ubt/fin/lut*sgb+jva+tej+yon+ahj/njg/hns+mps-jbr-umi*ngj+cvc+arn/yej/jpu-vyb
cvc=mps/jbr-umi+ngj-jpu
arn=wgd-bjs/mps-sdd/jbr+ngj*jpu
yej=ubt/raj-ile+jbr*ngj-cvc-ewc
hxw=wgd/raj*ahj/ile*bjs+sdd+jbr*umi+ngj/cvc+arn*jpu+ewc
kvq=ubt*mge/wgd-ile+sdd+jbr/gqy*umi/cvc-arn
onk=ckj/agq*sgb/jva-wgd*tej*yon+jiw+raj-nao-ahj/bjs+hns/mps+jbr-oyl/umi-ngj*cvc-hxw-jpu-ewc-xxt+mjt*vyb
mjk=ckj*agq*mge+lut-woj*wgd*yon+jiw-ahj/njg+mps*sdd-oyl/umi+cvc-arn/yej+hxw-jpu+kns-xxt/mjt
ewc=ahj-bjs+mps/jbr+umi
kns=ubt*sgb-ahj-ile-bjs-mps+sdd/umi-arn
xxt=ubt-sgb/ahj+ile/bjs/ngj-arn/jpu-ewc
mjt=ubt-sgb/ahj*ile/gqy-umi+ngj*cvc*arn
dqg=ckj+mge/sgb/woj+jva+yon*ile/bjs*njg/hns+jbr+oyl+gqy-cvc+arn+jpu+kns
vyb=ubt-sgb/wgd/raj*bjs+jbr*cvc/arn/jpu

