38
agq=ckj*fin+mge+jva+wgd/tej/jiw+otf+chl+fru/trg-bjs-mps+sdd*gqy/onk/ewc+dqg
fin=ubt-lut/otf-mps-umi+ngj+yej/hxw
mge=ece-ubt-jva/wgd+yon-ngj-yej*hxw*mjk
lut=ckj+yon+otf*fru-ngj-yej
dag=ece/mge*wgd+yon/otf*ahj-fru*mps*ngj+yej+hxw+ewc
sgb=ubt*lut-jva+yon/jiw*trg-bjs*hns*mps*ngj-lgl*kvq/mjk+dqg
woj=ckj+ece/ubt/fin-jiw+otf+bjs*njg+hns*sdd+oyl/umi*ngj*lgl+arn/yej*hxw*kns
tej=ckj-ece+ubt+lut+jva+wgd+fru*bjs*hns*mps/gdx*umi*ngj/yej+hxw-mjk/dqg
jiw=yon-fru-ngj/yej/hxw
raj=ckj-ubt*mge/wgd/ahj/fru-gdx/umi-lgl-arn*yej/hxw-kvq/dqg
nao=ckj/lut/jva/yon-otf+chl+fru*trg-umi+ngj-lgl/arn-yej+hxw+ewc
ahj=ece/ubt/wgd/yon+fru/yej*hxw+mjk
ile=lut/jva*yon*jiw-chl*fru*bjs*njg-mps*sdd*oyl-gqy/ngj-lgl/arn+hxw/onk-kns
chl=ubt+jva*wgd/ngj-hxw
trg=ckj-ece+ubt-wgd*ngj
bjs=ckj-jva-yon-otf/fru+ngj+yej-hxw
njg=ece-ubt/mge-wgd+yon*jiw/otf/chl*fru-bjs-mps-gdx*umi/ngj-hxw*kvq-ewc*dqg
hns=yej/hxw-mjk
mps=ubt+wgd+yon*ngj+yej*mjk
sdd=ckj+ece-ubt*mge+jva*yon-otf+ahj-chl/fru/trg/bjs/hns-mps-gdx/umi-ngj*yej-ewc*kns+dqg
gdx=ece+ubt*wgd*otf-fru*ngj
jbr=fin/dag+jva-wgd*tej-yon*raj-otf+chl+fru/bjs/njg/hns-oyl-gqy+umi/lgl*arn+hxw+kvq-onk-ewc/kns
oyl=ckj*ece+lut/jva+wgd/yon/otf*chl/trg/bjs/umi*ngj/lgl/arn+yej+mjk+ewc/dqg
dkn=ckj/ece+mge-lut*jva*tej-raj*otf*hns*mps/gqy*umi/ngj+lgl/arn*yej*hxw*kvq/onk+ewc
gqy=ckj*ubt+lut*wgd+yon-mps-umi-mjk-kns+dqg
umi=ckj/ece/ubt+wgd-otf+fru+hxw
lgl=ckj-ece+wgd-yej
cvc=ece+fin+mge-lut/wgd+yon-jiw/raj*ahj*chl*fru*trg/bjs/hns*gdx/gqy+umi-ngj*yej-hxw-kvq-onk
arn=ckj/ece/ubt/jva/wgd*yon+otf*fru+ngj*yej
kvq=ckj/ubt
onk=lut-yon+ahj/trg/ngj-lgl/arn*yej*hxw*kvq-mjk+kns-dqg
jpu=ckj-ubt/mge/sgb*jva-tej*yon*jiw-raj/chl+fru*bjs+njg-mps-sdd/oyl+gqy+umi-lgl-hxw*onk*ewc
ewc=ckj+ece*yon-otf+ngj/hxw
kns=ece/ubt+jva*wgd+yon/otf*fru+hxw
xxt=ckj+ece/fin+mge-wgd/raj*otf-ahj-chl-fru+trg/njg/sdd-gdx+oyl-gqy-ngj*lgl*arn+yej+kvq/onk/mjk+ewc+kns-dqg
mjt=ckj*mge+lut/dag*sgb*jva+wgd/tej-yon-jiw/nao-ahj-fru-mps*arn-yej+hxw/kvq*onk+mjk
dqg=ckj
vyb=sgb*jva+wgd+tej/yon+jiw/raj/otf*chl+fru+trg+bjs+hns/sdd+gdx-ngj-lgl+yej-kvq-dqg

