50
ckj=fin+lut/sgb*jva-tej*yon+raj+nao/ahj+chl*trg*bjs+njg-mps/gdx-oyl+dkn-gqy-ngj-lgl/cvc*arn+yej/mjk+dqg
ece=ckj*ubt/agq*fin/dag*jiw*raj/nao*ahj+ile-chl+bjs/hns-sdd/gdx-jbr/gqy*arn/hxw-jpu-ewc+mjt/dqg/vyb
ubt=agq*dag/sgb/jva-yon/nao*otf/ahj*ile+chl-trg+bjs+njg-hns/mps/jbr*gqy-umi*lgl+cvc+arn*hxw+kvq/onk+kns/xxt/dqg
agq=ckj*fin-mge+lut+dag-sgb-woj-jva-otf-ile+njg+mps/jbr/dkn+umi*yej+hxw*kvq+onk-jpu-ewc+dqg
fin=ece*mge+lut-dag-sgb*woj+jva-wgd*tej+raj-chl+fru*bjs-njg+sdd*gdx-jbr+oyl-umi+ngj-arn*kvq+jpu+dqg/vyb
mge=ece/dag+sgb/woj+wgd+yon*jiw*raj*ile/trg*hns/jbr/oyl*ngj-arn/yej*kvq-ewc*kns+xxt+mjt+dqg
lut=ece/fin-mge+sgb/woj-jva+wgd-jiw+raj*nao/ahj+ile-chl+fru-trg+bjs-sdd+gdx-jbr*oyl/umi/hxw-kvq+jpu*mjk+xxt
dag=ece+agq-lut/wgd/raj+nao-otf/ahj*ile*chl*fru/njg+sdd/gdx*jbr+dkn+gqy*umi+ngj-lgl/kvq-onk*ewc*mjt*dqg/vyb
sgb=ckj/agq-fin-mge+lut/jva-tej*raj*otf/ahj-ile*bjs-njg-mps+sdd-gdx-oyl+dkn*umi+ngj+lgl+cvc*hxw+onk/jpu+kns/xxt
woj=agq*mge/lut*dag*sgb*wgd+tej*yon/jiw-nao+fru-trg-bjs/njg-sdd+gqy*umi-arn*yej*jpu/kns*mjt/dqg/vyb
jva=ece/agq/mge+lut+yon-jiw-nao*fru+trg*bjs/njg/hns+mps-gdx+oyl-dkn*umi+lgl/cvc-arn+yej+hxw-kvq+onk+kns+dqg/vyb
wgd=ckj/ece+ubt/agq-fin*mge/lut+sgb/jva+jiw+nao+chl-fru/trg*bjs-hns*mps-sdd+umi*ngj/hxw-kvq-onk*mjk+kns*xxt/mjt+dqg-vyb
tej=ckj+ece/agq/sgb-woj+wgd-jiw*hns-mps+sdd*gdx-jbr+gqy-cvc/onk*mjt*dqg
yon=ckj+ece/agq-mge*lut/jiw*raj/otf/ile*njg-hns+mps/gdx+oyl+dkn+arn/hxw+onk+jpu-mjk/ewc/kns*mjt+dqg/vyb
jiw=ckj-ubt/agq*fin+tej-chl/trg+bjs+njg+hns/mps*sdd+gdx/jbr+oyl-gqy-ngj+cvc+arn*yej-kvq*onk*jpu-ewc/xxt*dqg-vyb
raj=ckj-ece-agq-lut*sgb-woj/wgd+nao*ahj-ile*trg/bjs/njg+hns+mps+sdd*jbr+oyl/dkn*gqy+umi-ngj-kvq*onk+mjk-ewc*mjt+vyb
nao=ckj*ece*fin/mge+dag+sgb*yon/jiw/raj+trg-bjs/sdd/gdx*hxw-onk*ewc*xxt
otf=fin/mge*sgb+jva*wgd-tej*nao-ahj+ile/trg/bjs-njg-sdd-gdx/dkn/gqy-lgl/cvc-yej/kvq/mjk*ewc*kns+mjt-dqg
ahj=ece-agq+lut-jva+wgd/tej*yon*jiw*raj+otf*ile*fru-trg/njg+sdd+gdx+jbr/oyl*dkn/umi+lgl/cvc*arn-yej+mjk-kns/mjt
ile=ckj-ece-ubt*agq*mge/lut+sgb+woj+jiw-otf+bjs+mps-gdx*jbr+oyl-gqy*umi*arn-yej-hxw-kvq*ewc-kns
chl=ckj/agq-fin*lut-dag*sgb/woj-jva/fru*bjs-sdd-jbr-gqy+lgl*kvq-jpu+mjk/kns*dqg-vyb
fru=ckj/ece+lut-sgb*yon-jiw+raj/ahj/trg*bjs-hns+mps/jbr-oyl*ngj+cvc/arn-yej+hxw+onk-jpu+kns*xxt/dqg
trg=ece*sgb-jva/wgd-yon*jiw-raj-ile*chl-bjs+mps-jbr-oyl*gqy-ngj+arn*yej+hxw*kvq/jpu*mjk*xxt+vyb
bjs=ece+agq+lut*dag-woj-jva-wgd+yon+nao/ahj*chl+trg/hns+jbr*oyl*gqy*umi-lgl+cvc+yej+hxw+onk-mjk-dqg+vyb
njg=ece*fin+mge+lut*dag+yon+jiw*raj/nao/ile+chl/trg/bjs+mps/sdd+gdx-oyl/dkn+gqy-umi+lgl-cvc*arn*yej+kvq*onk/ewc-xxt+dqg*vyb
hns=ckj*ece-fin-wgd*jiw/raj+ahj*chl*fru/trg+mps+gdx+oyl/dkn/gqy/lgl/cvc+arn/yej*kvq/onk-jpu+mjk+ewc*xxt+vyb
mps=agq/fin/mge-lut/dag/wgd*tej-raj/chl+trg*bjs+hns/jbr-dkn-ngj*cvc+arn+yej/jpu*ewc*kns*xxt+mjt-vyb
sdd=ubt/agq/fin*dag/sgb*yon*fru-trg+njg/mps+jbr-dkn*cvc*arn-yej/kvq*onk-mjk/ewc-xxt
gdx=ckj/ece+ubt*agq*lut+yon+raj-nao*otf-ahj*njg/hns-umi*ngj*cvc/arn/kvq+jpu*mjk-kns/xxt-dqg
jbr=ece/ubt*agq+fin+mge*sgb*jva+wgd-otf-ile*chl/njg*mps+oyl-dkn+ngj/lgl+cvc-arn-yej+mjk/ewc+xxt*mjt*dqg
oyl=ckj+mge+lut-woj+jva-yon/jiw+nao*otf/fru/trg-bjs-hns/mps+sdd-gdx/dkn-umi/ngj*lgl*cvc+yej*hxw/kvq-onk+jpu+ewc-kns-xxt
dkn=ckj*ubt-agq-fin+mge/dag-tej*jiw-raj+nao-sdd*gdx*gqy+arn-jpu+mjk-ewc*xxt*mjt
gqy=agq+fin+dag/sgb-woj+tej*raj*otf-ile/chl-fru+trg-sdd-jbr*oyl/umi*lgl+cvc+yej/kvq*onk-mjk/mjt
umi=ckj+agq+mge+lut+dag+woj-jva+wgd+tej/yon/raj-nao/ahj-ile/chl/fru-trg-gdx/oyl*dkn-ngj-cvc-hxw/kvq+jpu+mjk-ewc
ngj=ece*ubt+woj/wgd/yon+jiw+raj-nao+ahj*fru+bjs+njg*hns*gdx-jbr+dkn+gqy/umi-cvc-arn/onk-jpu-kns*xxt/dqg
lgl=ckj+ece/ubt-agq/mge*sgb-yon-nao*fru*bjs*hns+mps-sdd+jbr-oyl-hxw-jpu-mjk/kns*mjt*vyb
cvc=fin/mge*sgb/wgd*yon/raj*nao/otf+ile/chl/fru-oyl/dkn+umi/arn+yej/kvq+onk*jpu-mjt/dqg
arn=ubt-agq/fin/lut+woj+jva-nao/otf-ahj/chl-hns-gdx/jbr-oyl-gqy+umi/yej/mjk-xxt-mjt
yej=ckj*ece+ubt/agq-fin+mge/lut/sgb*woj-tej-yon*jiw*raj*otf-fru+trg+bjs*njg-mps*sdd+gdx/jbr*oyl/dkn+umi-ngj*cvc-arn-mjk-ewc+xxt*mjt/vyb
hxw=ckj+fin*mge-dag/jva+wgd/tej+raj+nao/otf/ahj+ile*fru-trg/hns-gdx*dkn-umi/cvc/arn/yej/kvq/kns*mjt
kvq=ckj+ece+agq*fin*dag*wgd-yon+nao/ahj+ile/fru*trg*bjs*sdd/jbr*dkn+gqy-umi*ngj-lgl/arn*hxw*onk-jpu+vyb
onk=ece*agq*dag/sgb-wgd-tej/raj/chl/bjs-njg*hns*sdd+jbr-oyl/dkn+gqy+ngj+lgl+cvc-yej-kvq/jpu*mjk+kns
jpu=ckj*ubt*agq-lut-woj+wgd+tej+jiw/otf/fru*mps+sdd-gdx+jbr/oyl+dkn-gqy/lgl/cvc*kvq/onk-ewc/mjt-vyb
mjk=ckj-ece*fin-lut-dag/jva+wgd-tej*otf+ile+hns-gdx*oyl/cvc-arn/kvq+ewc+kns*xxt+mjt*dqg+vyb
ewc=ece/lut/sgb*jva/wgd-tej*jiw*nao-fru/trg+bjs+njg+hns/mps/sdd*gdx/jbr+dkn+gqy*umi*arn-jpu/mjk+kns+xxt/mjt+vyb
kns=ckj-ubt*agq-fin-lut/woj/tej-jiw+raj/nao/otf+ahj/chl*trg-bjs*sdd-jbr/oyl/dkn+gqy*lgl+cvc+yej/hxw/onk/mjk/ewc/xxt-dqg*vyb
xxt=agq/fin-mge/lut+dag+sgb/tej-yon*jiw-nao/otf*ahj+chl/hns+gdx+dkn-umi/lgl+arn-yej-hxw+onk/jpu-ewc*mjt+dqg*vyb
mjt=ckj-ubt/agq/mge/sgb+jva*wgd+tej/yon/jiw+raj+otf/ile/chl/fru*bjs-njg-mps-jbr+oyl*ngj*lgl/yej*kvq+onk-jpu*mjk+ewc*kns/vyb
dqg=ece+ubt+fin-dag+yon*otf-ahj/ile-chl/fru/trg-njg*oyl-gqy/lgl/cvc-arn*yej+hxw+kns+xxt/vyb
vyb=dag*woj-yon-nao/ahj-trg+bjs-njg/hns/mps-jbr/oyl/dkn-gqy/ngj/cvc/arn-yej+hxw/kvq-onk-jpu-ewc+dqg

