33
ckj=agq+dag*wgd-jiw+bjs-hns-gdx+umi+lgl/yej
ece=ubt/mge*lut/dag+woj/jva*jiw+nao*ile+trg+bjs*mps*gdx+jbr+oyl/dkn-umi/lgl*arn+yej-onk/mjk/ewc
ubt=lut*dag/wgd*jiw+nao-njg/gdx/jbr*dkn+umi-lgl*yej
fin=agq/lut+dag/wgd-ile+trg+bjs+hns/sdd-jbr-oyl/dkn-yej-kvq-onk*jpu*kns*dqg
mge=dag/njg-mps/jbr/umi-lgl+yej
sgb=agq+lut/wgd+nao*bjs-njg*jbr/dkn+lgl/yej
woj=agq/wgd/jiw/bjs-gdx+jbr-yej
jva=agq+lut+dag-jiw-hns*mps/dkn*umi+yej
tej=ckj-agq*dag-woj-jva*yon*jiw/nao+njg+hns-sdd-jbr+umi+arn*jpu-kns/dqg
yon=dag*wgd/jiw-bjs-njg+hns-gdx/jbr+umi/lgl-mjt
raj=ubt*agq*mge+lut/woj-wgd+yon+ile/trg/mps/dkn/lgl+yej-jpu-mjk/kns
otf=dag*woj*jva*wgd*yon*njg-mps+oyl-dkn+umi-yej*jpu-mjk
ahj=ckj-agq/dag-sgb/jva-wgd-jiw-njg+gdx/dkn/arn+yej/jpu+mjk-mjt
ile=lut-nao*njg-mps/umi+lgl+yej-mjt
chl=ubt-mge*wgd*ile+trg-njg-mps/sdd/gdx*jbr-dkn*umi+lgl*ewc*mjt/dqg
fru=ubt/lut*dag+sgb-jva-wgd+yon+jiw-nao+ile*lgl-kvq-onk/mjk/ewc/kns
trg=lut*wgd-jiw/njg-mps/umi*lgl/yej
sdd=agq/nao-njg*mps/gdx/umi
oyl=agq*wgd*jiw-bjs-njg+mps
gqy=ckj*mge-lut*dag+sgb/woj/jva*wgd/yon/nao-bjs/njg+gdx/jbr*dkn/arn*yej*kvq-ewc/kns+mjt
ngj=mge*sgb*woj-jva-yon*jiw+nao+ile-trg/hns*sdd*jbr/oyl/dkn*lgl/kvq+jpu/kns*mjt+dqg
cvc=ckj-mge+lut*dag-woj/wgd*jiw-nao-hns/sdd*dkn*umi-yej-onk/jpu*mjk-ewc*kns
arn=agq-dag*jiw*nao+bjs/hns+mps+jbr-dkn/lgl
hxw=ubt+sgb/jva*wgd+jiw-nao-ile*njg/hns*mps*sdd/gdx/dkn/umi/kvq*onk*jpu-ewc-kns/dqg
kvq=lut*wgd/nao/bjs+njg-mps*lgl-yej*mjt
onk=lut-dag/nao*bjs-mps-jbr-dkn*umi/yej
jpu=lut+dag*jiw/nao-hns/lgl-yej
mjk=lut/dag+jiw-nao-hns+gdx+dkn
ewc=dag*wgd-jiw-njg/mps*gdx-umi/yej
kns=agq/lut-wgd/jiw+nao/gdx*dkn+umi/lgl+mjt
xxt=ckj*lut*woj+nao/ile/bjs+njg*hns-mps*sdd+gdx/jbr/dkn/arn+yej-onk-jpu-mjk*kns/dqg
dqg=lut+wgd/jiw-nao*mps+gdx/jbr*dkn-yej
vyb=ubt+mge+lut/dag+woj+yon-jiw-nao-hns/sdd/gdx-oyl-umi*lgl/arn+yej-mjt

