50
ckj=ece*woj-wgd/tej+raj*nao/otf+ile-fru/bjs-njg*mps*gdx*dkn+ngj+yej-hxw-kvq/onk/jpu+ewc*xxt+mjt
ece=agq-fin-mge*dag/sgb/woj/jva/wgd*jiw*otf/ahj+chl/fru-njg*oyl-dkn/ngj*lgl-cvc+yej-kvq+jpu-ewc/mjt*dqg
ubt=ckj*ece-fin*mge*dag-woj+wgd+tej+ahj-ile-chl/fru*trg-bjs-hns/mps+sdd+jbr-gqy+umi/lgl*cvc+hxw-kvq+onk-mjk-ewc/kns-xxt-vyb
agq=ckj+ece/ubt/mge+wgd+raj-nao+otf+ahj/chl*gdx/dkn+gqy-lgl*arn*yej*hxw-jpu+mjk*ewc/kns+mjt*dqg
fin=ckj/ece-ubt/agq*mge+lut/woj-yon/jiw-raj/chl+bjs*sdd-gdx+gqy+yej-hxw/onk*mjk/ewc-kns*dqg
mge=ckj-ubt+agq*dag/sgb/woj-wgd*jiw-otf/ile-trg+bjs*njg+hns/mps+sdd*gdx*gqy+ngj*arn/jpu-mjk+kns*xxt
lut=ckj*ece+mge*sgb+woj/wgd+tej*yon-raj+nao*otf*ahj/trg*njg-hns+sdd/gdx/oyl-ngj/lgl/cvc*hxw-kvq*onk+kns+xxt+vyb
dag=ece/ubt-agq+sgb+woj+yon+jiw+nao*otf+chl*trg-bjs-njg+sdd*jbr-gqy*umi*ngj+cvc+arn*hxw*kvq+kns+dqg+vyb
sgb=ckj/agq/fin*jva*wgd+tej/raj/nao-otf+ile/chl*fru-bjs/njg/hns*sdd-jbr+oyl+dkn/gqy-ngj+cvc+hxw+kvq/onk+kns*mjt-dqg
woj=ece/lut*dag+sgb/wgd-yon*jiw+otf-ahj*ile/fru+trg+hns*gdx-jbr*dkn/gqy-umi*cvc+arn-yej+jpu-ewc*xxt+dqg
jva=ckj+ubt-fin+mge*lut/nao/ahj-fru+trg/bjs/njg*mps+sdd+oyl+umi/lgl-yej-onk+jpu*mjk*kns-dqg-vyb
wgd=ckj/agq+fin-mge+lut*dag/sgb+jva-yon-fru/njg+sdd*jbr/dkn*umi*ngj+lgl/cvc-yej/onk+ewc-kns
tej=agq/lut/dag-sgb*woj-wgd-yon/chl*bjs+njg-mps-oyl+gqy*umi*yej/hxw*mjk*kns/xxt*mjt*vyb
yon=ckj/ece+ubt/fin*lut*dag-woj*tej-nao-otf*chl+bjs+hns+mps-sdd*gdx+dkn-ngj*cvc+arn-yej/kvq-onk*jpu*mjk/ewc*kns*vyb
jiw=agq-fin/lut-sgb*yon*otf/chl-fru-njg-hns*sdd+gdx-oyl+dkn+gqy-umi+ngj/lgl/arn*yej+hxw*kvq-jpu-ewc+kns-mjt/dqg-vyb
raj=ckj-ece/mge+sgb-jva-tej-yon/ile+chl*trg/bjs-njg+sdd+gdx*jbr/gqy*umi/cvc+hxw/onk/ewc-kns/vyb
nao=ece*fin+mge*lut*dag-sgb+woj+wgd-yon+jiw*chl+bjs/njg/mps-oyl+umi/lgl*cvc-arn-yej+hxw*jpu-ewc*kns+dqg
otf=mge*lut+jva*wgd*tej*ile+fru+njg*sdd*jbr-oyl*dkn/gqy/ngj+cvc+arn-kvq/jpu-ewc/kns-xxt*mjt
ahj=ckj/fin-mge-dag-sgb+jva/raj/ile*chl*trg*njg-jbr*dkn+gqy*lgl+cvc*hxw*kvq/ewc/kns+xxt*mjt-dqg+vyb
ile=agq/mge+lut*dag*wgd-nao-trg/bjs/hns+sdd+gdx-jbr/oyl*gqy-lgl*hxw*mjk-ewc/kns-dqg
chl=ckj-ece*ubt/fin-mge+woj-jva*tej+yon/raj-nao*ile*trg/bjs*njg+mps/sdd/gdx*jbr/oyl/dkn+gqy*umi/ngj-cvc*arn+yej*hxw-kvq*mjk+kns-dqg-vyb
fru=ckj/ece*fin/lut/dag+jva+tej*raj-nao*otf+ahj*ile-njg+sdd-jbr/oyl-dkn+umi/hxw+kvq+onk*mjk/ewc*kns-xxt-mjt+dqg/vyb
trg=ckj*agq/fin-mge*lut/sgb*yon*jiw/nao*ile+chl*njg-hns/sdd-jbr+oyl*dkn*gqy-umi*lgl-arn/hxw/kvq-jpu/mjk*xxt-vyb
bjs=ubt+agq-fin-mge*dag*woj*jva*tej/yon/raj+otf+ahj+ile+fru+hns+mps+sdd-jbr/oyl*dkn+umi+ngj*cvc*arn-yej*hxw-jpu-ewc+kns/xxt+dqg-vyb
njg=fin/mge/lut+dag*wgd-tej*otf-fru+bjs*hns-mps+sdd*gqy*ngj+cvc-arn+hxw-onk-mjk/xxt
hns=ubt-mge/lut-tej*yon+ahj-ile+chl-njg/mps*sdd*jbr-gqy+umi/ngj/lgl+cvc-arn+jpu/mjk/ewc*vyb
mps=ece+ubt/dag*sgb*wgd/yon-fru/trg+bjs+njg/hns*jbr+dkn*gqy*ngj*lgl*cvc/yej/hxw/kvq-onk+ewc+mjt-dqg*vyb
sdd=ece+fin/mge+lut*woj*jiw/raj+otf+ahj-ile*bjs+dkn*umi+cvc*arn*hxw/kvq-jpu+ewc/mjt/dqg
gdx=ckj*ece-ubt-agq-fin+mge/sgb-woj+jva/tej+yon+nao*otf-chl+fru+bjs*hns-jbr-oyl+dkn*lgl*cvc+yej*hxw*onk*mjk*kns-xxt+mjt+dqg/vyb
jbr=ckj-fin+mge/woj*jva+tej*nao/fru*njg*sdd/gdx-oyl*lgl+yej*kvq/ewc/mjt+dqg*vyb
oyl=ubt*fin+lut*wgd+tej/ahj*trg-bjs/sdd+gdx/dkn-jpu*mjk-ewc+kns-xxt/mjt
dkn=dag*sgb/jva-wgd*raj+nao+ile-chl+trg+bjs+mps-sdd-jbr/oyl+arn/yej/mjk/kns*xxt
gqy=ckj+ece/agq+fin-lut*sgb-woj+jva+jiw/ahj/ile*fru*trg/gdx+jbr/dkn-ngj-lgl+cvc*yej+kvq-mjk*kns+dqg*vyb
umi=ece-mge-sgb+woj/tej*yon*nao*otf+ahj-bjs/njg/sdd*gdx+jbr/gqy*arn*kvq*onk*mjk*mjt+vyb
ngj=ckj-ubt*lut-dag-sgb/woj*wgd/tej*ile*fru-trg+bjs+hns*mps/gdx-jbr*oyl+dkn+lgl+cvc+arn*hxw+jpu-mjk+ewc/kns+mjt*dqg+vyb
lgl=ckj-fin+lut/dag+woj+jva*wgd/tej-jiw*raj*chl*fru*trg*bjs*njg*hns+mps+sdd*dkn+gqy*jpu+mjk+kns*xxt+dqg
cvc=ece/lut*sgb/woj/jva-tej+yon*jiw*otf*ahj-fru*bjs*njg+hns-mps*oyl+dkn/gqy-lgl+arn/hxw-kvq/onk-mjk+kns-xxt+dqg+vyb
arn=ubt+mge/dag*sgb+woj*wgd*jiw+nao+ahj*ile-trg*mps+jbr*gqy-cvc/yej+kvq-onk/kns/xxt/dqg-vyb
yej=ubt+agq-fin/lut-jva/tej+yon+raj*nao-otf-chl*fru*bjs-njg-hns/mps-sdd-gdx+jbr+umi-cvc-mjk+ewc-kns*mjt-dqg
hxw=ckj/fin/mge-lut+dag-woj*jva*ile/chl-trg-bjs/njg+hns*sdd-gqy*ngj/lgl*onk*mjk+kns*mjt/vyb
kvq=ubt-fin*mge+lut-sgb+woj+jva/wgd*tej*otf+trg-njg-hns*gdx-oyl-ngj/yej*hxw*onk*jpu/ewc-xxt*mjt
onk=ece*agq/wgd-tej-otf-ahj/ile-fru/bjs*jbr/oyl+dkn-gqy-umi-cvc-yej*hxw-kvq+jpu/mjk*kns+dqg
jpu=ckj*ubt*fin-dag+sgb-jva-wgd*jiw*nao/otf-ahj+ile/fru+hns/jbr-oyl+dkn*ngj/cvc*kvq*onk+mjk-ewc/vyb
mjk=ece+ubt/fin/mge*woj-jva+tej-ahj-chl+fru/trg*jbr/gqy*umi-lgl*yej-kvq-jpu-kns*mjt-dqg/vyb
ewc=ece-agq*lut-dag*woj*yon+otf*ahj/ile/njg+hns-sdd-gdx-jbr+oyl/gqy*umi*lgl*cvc-arn/yej+kvq-jpu+mjk/xxt+mjt/vyb
kns=ckj-lut/sgb*woj*jiw+raj/nao+otf/ahj/ile/chl-fru*njg*hns-mps+gdx*jbr+oyl/umi*ngj*cvc*mjk-mjt-vyb
xxt=ece/ubt/mge/sgb*jva+tej-yon-jiw*otf/ahj/trg/njg*mps+sdd*gdx-jbr+dkn+gqy*ngj*lgl-arn+hxw-jpu-mjk*dqg
mjt=ckj*ece/ubt*woj-jva/ahj*fru+trg/njg*hns+sdd/gdx/jbr+oyl/dkn*gqy*umi/cvc-arn-hxw/kvq+kns+xxt*vyb
dqg=ece-woj/wgd-yon+raj*njg/jbr-dkn*gqy*ngj-lgl-arn/ewc-kns*xxt
vyb=ubt/agq/fin-dag/sgb/tej-yon*raj-nao-chl-fru-bjs+hns/sdd/gdx+dkn+gqy/umi-ngj/lgl+arn+kvq/onk-mjk-kns-mjt*dqg

