42
ckj=jva+raj+nao/sdd*jpu
ece=fin+lut/tej-yon/nao/bjs-hns-sdd-lgl-kvq
ubt=ckj-agq-tej+ile*bjs/njg-jbr/jpu+mjk/dqg
agq=jva+nao/sdd/jpu
fin=raj-nao+sdd*oyl+jpu
mge=ckj-fin/lut/tej*yon/nao-otf*ile*bjs/hns-lgl*kvq-jpu
lut=yon-raj/nao/oyl*dqg
dag=agq-fin*lut/jva/yon*otf-ile/njg/hns*jbr/oyl/jpu/dqg
sgb=agq/fin-jva-raj*nao/ile-njg+hns-gdx*jbr-oyl/lgl/jpu-mjk+dqg
woj=fin*tej/yon*sdd*kvq-mjk
wgd=ckj+yon/nao*otf-ile/bjs+sdd*gdx-jbr*oyl-lgl/kvq+jpu
tej=jva*raj*nao+sdd*oyl/jpu
jiw=ckj+agq+fin-lut+tej/yon-raj+nao/otf*ile+njg+hns*sdd/oyl*kvq/mjk*dqg
otf=yon*nao/oyl
ahj=agq+lut/tej-raj+nao-ile*bjs*sdd*kvq+jpu
ile=jva-raj+dqg
chl=agq+jva*tej*yon/nao-hns-sdd+gdx/oyl*lgl*kvq*jpu/mjk
fru=ckj/fin*lut+tej*nao*ile*bjs/njg/sdd+kvq*jpu/mjk
trg=ece-ubt-agq+fin+mge+lut/dag-sgb-woj-wgd+tej-yon/raj/chl/bjs*njg-hns+umi-lgl+arn/hxw/jpu-mjk-dqg/vyb
bjs=yon/jpu*dqg
njg=yon/sdd+oyl/jpu-dqg
hns=yon*raj-nao/jpu
mps=dag/wgd/raj*ahj/chl/fru+bjs+hns*sdd*gdx*dkn/gqy*lgl+kvq*mjk*kns*xxt+mjt-dqg
gdx=yon-raj-nao+sdd
jbr=jva*yon/raj*nao*sdd/oyl
dkn=ckj/lut+yon*raj*otf*ile*bjs*hns/gdx+oyl*lgl*jpu
gqy=agq+fin/lut-tej+yon-raj-nao-bjs-njg*hns/sdd-oyl-lgl/kvq*jpu+dqg
umi=ckj+agq*lut-jva*yon-raj+njg*gdx-jbr*oyl+mjk
ngj=ckj+ubt/agq+fin-mge-dag-jva-yon/raj*otf-ile-chl*fru+njg/sdd*oyl*gqy+umi/hxw*kns-xxt
lgl=jva*yon+oyl*jpu-dqg
cvc=ckj-ece/ubt/agq/fin+mge+sgb/woj+tej*yon+raj-nao*otf*ile*fru-bjs/sdd*jbr-oyl*dkn-gqy/lgl-hxw+kns*mjt*dqg+vyb
arn=ckj*lut+tej+yon/raj-otf*ile/jpu*mjk
yej=ckj*agq/fin*tej/yon-nao-ile/bjs*gdx/jbr+oyl-lgl+jpu
hxw=lut*jva*tej*nao+otf+ile+njg+hns+sdd/gdx/jbr/lgl*dqg
kvq=jpu
onk=agq-fin+mge+lut+sgb+jva+wgd+nao+otf+fru-njg*gdx/jbr/gqy-umi*arn-hxw-kns-mjt/dqg-vyb
mjk=yon/raj/jpu
ewc=ckj+lut*jva-yon*bjs-njg*gdx-jbr+kvq*jpu+dqg
kns=ckj-lut+tej/yon-nao*ile+sdd*oyl*kvq
xxt=ckj*jva+raj+nao+ile-bjs*njg*hns-oyl*lgl-mjk
mjt=lut/yon-raj-nao-otf/ile*njg*sdd-jpu
vyb=agq+fin+raj*nao/bjs+hns-sdd+oyl/kvq

