39
ckj=ubt*sgb+woj/raj/fru+njg*umi*cvc+arn*kns
ece=agq/mge+sgb*tej*yon*raj*nao-hns+gdx/dkn-gqy+umi*lgl*xxt
agq=ubt/jva/ahj/njg*dkn
fin=ckj-ece+dag+sgb-wgd+yon-nao*chl*fru*trg-bjs+gdx/gqy-ngj-lgl/cvc*arn-hxw-onk/kns+xxt/dqg
mge=ahj+njg+hns/onk
dag=ubt-lut-fru*dkn-kns
sgb=lut/ahj/fru-dkn-umi*onk+kns
woj=lut-jva+njg+hns/umi+kns
wgd=ubt*agq*lut/woj+tej*raj+ahj+chl/hns-gdx*dkn*lgl/cvc+arn/hxw+kns*xxt
tej=agq+mge*lut+dag*woj-raj+ahj-fru/njg+dkn/gqy*cvc*hxw*dqg
yon=ubt*mge*jva+raj-ahj-cvc/hxw-onk
jiw=ckj-ubt-agq+lut-wgd*tej*yon+raj-otf-ahj*chl/trg/oyl/dkn/umi*ngj-lgl-cvc+arn+hxw+onk-xxt+dqg-vyb
raj=ubt-lut+onk
nao=agq*lut-dag-sgb-woj*jva-ahj/fru+dkn-arn-onk
otf=mge+sgb*jva-yon*raj/ahj-chl+hns-sdd-lgl+arn+hxw/onk/jpu*kns+xxt-dqg
ile=ckj*agq*mge-woj-jva+wgd*tej-raj*otf+chl/trg/bjs+hns*sdd-gqy/lgl/cvc+yej-hxw+dqg*vyb
chl=agq*lut*sgb+raj/ahj+fru-hns/gqy+umi+arn
trg=ckj*ubt/mge-dag*sgb+jva/yon*raj*chl-njg*sdd/dkn/arn/hxw-onk-jpu-xxt
bjs=ubt*lut*ahj+njg-sdd+gdx-dkn*cvc*onk+kns+xxt
mps=ece+ubt*agq*dag+sgb+woj/jva+yon*fru*trg*bjs*njg-gdx/jbr/dkn*ngj-cvc+arn+yej/onk/jpu-vyb
sdd=mge-lut+sgb/woj/njg/hns+gqy/umi/hxw+kns
gdx=dag+woj/raj+fru*gqy/arn-hxw/onk/kns
jbr=ubt/agq/mge/lut*dag/woj*jva/tej+nao*njg*hns+sdd/gdx+dkn/lgl*arn+hxw*jpu+xxt*dqg
oyl=ubt*mge-lut/woj-tej*yon*raj+nao/chl-fru*sdd*dkn*gqy/umi/cvc-arn-kns*xxt-dqg
gqy=jva-njg/dkn-umi
ngj=ckj+dag*sgb/jva*tej*raj-nao+fru*njg/hns*sdd*gdx-dkn*cvc-arn-hxw*onk+dqg
lgl=mge/lut+sgb+jva-raj*fru/njg/hns*dkn/arn+dqg
cvc=lut-fru-njg*kns
arn=ubt/njg-hns+onk
yej=ckj+ubt-dag*woj*chl*njg*hns*gdx+dkn-onk-jpu*kns*xxt
hxw=lut+fru/njg-dkn/umi*onk
kvq=ckj-ubt/mge+dag+woj-jva+yon/raj-nao-fru+njg/sdd-dkn-gqy*umi+lgl/jpu-kns+dqg
jpu=agq+mge-dag-jva*ahj/hns/onk*kns/dqg
mjk=ece*agq-lut*sgb-woj/jva/yon-ahj*trg*bjs/hns+jbr-umi+ngj/cvc/kvq-onk-xxt+dqg+vyb
ewc=ckj*ubt-agq+sgb*woj*jva/wgd+tej/nao*otf*ahj-chl/fru/bjs+oyl/umi*arn*yej-kvq*kns+xxt
xxt=agq/jva-raj/fru-umi*cvc-arn
mjt=ubt-agq/lut+dag-sgb-tej-yon*raj/otf-ahj/chl*fru/sdd-jbr+umi-cvc+yej/hxw+kvq*jpu+xxt+vyb
dqg=ubt*lut/ahj/njg*dkn-umi*kns
vyb=ckj*lut*sgb+jva-tej-yon*nao+ahj*njg-hns/sdd*cvc/onk/xxt+dqg

