50
ckj=ece*agq/dag*sgb*woj-jva/wgd-tej/jiw/otf/ahj/chl+bjs-njg-hns*mps/oyl-lgl*arn*kvq-jpu+kns*xxt-mjt*dqg/vyb
ece=ckj+agq/sgb-tej+raj/nao+ahj/chl/fru/njg+hns/mps-oyl+umi-ngj+lgl-arn*onk+jpu-ewc/xxt+mjt-dqg
ubt=fin/mge+lut/dag-woj+jva*wgd*tej/yon+jiw+raj/otf*ahj/ile*chl*fru-trg-hns/sdd+gdx+jbr-oyl*dkn*gqy/ngj-cvc/yej+hxw+kvq+jpu+mjk+xxt-mjt/dqg+vyb
agq=ubt/mge/wgd-jiw-nao/otf/ile/trg/njg-hns*gdx-jbr-oyl+umi/lgl*cvc*hxw+kvq-onk-jpu/mjk-ewc+xxt*dqg/vyb
fin=ece+lut*dag*tej/yon-jiw*raj*nao*otf/ahj-chl*njg*oyl/dkn/gqy-umi*kvq-mjk-ewc*xxt-mjt
mge=ckj+fin/lut-sgb*woj*jva*wgd-jiw+otf+ile+chl+trg+bjs-mps-sdd+gdx/oyl+gqy-arn+yej+hxw/kvq/jpu/kns
lut=ckj-ubt/dag-wgd*tej/raj-otf+ile*chl*bjs-njg-hns*mps+sdd+jbr/dkn/gqy/umi/cvc-arn-yej/hxw+onk-jpu/mjk/vyb
dag=ece/sgb+woj/wgd-jiw/raj*nao*otf+ile*fru-njg+mps*sdd-jbr+dkn*lgl*arn-yej/hxw+kvq+onk*jpu+mjt-dqg
sgb=ckj-fin/mge+dag*woj-tej-yon-nao*otf/ile-chl-bjs/mps+sdd+gdx+jbr-ngj-lgl/mjt*dqg
woj=mge-lut*wgd*tej-yon-nao*otf+ahj-ile/chl/fru*trg/gdx-gqy/ngj*cvc/hxw-onk-jpu-ewc*kns+xxt-dqg*vyb
jva=ckj*ece*ubt/fin-mge+sgb-woj/wgd+jiw/raj/fru*trg*njg+hns/mps+jbr*umi-ngj*lgl/cvc+arn*mjk*ewc+kns
wgd=ece-agq-mge+lut-woj/tej+yon+jiw/otf-ile+hns+mps-jbr-ngj/yej+onk-kns+xxt-mjt*dqg
tej=ubt/agq+fin+mge+lut+sgb*woj+jva*wgd+yon-jiw-nao/ahj-chl-trg/mps/sdd-gqy-umi+lgl/cvc-arn+kvq-ewc/xxt+mjt-vyb
yon=ece/ubt*agq-lut-dag-sgb-woj+wgd+tej/jiw-raj/nao/ile/chl/fru/trg/njg*sdd/dkn-cvc+yej-xxt+mjt
jiw=ubt-agq*mge/woj-wgd-tej-fru*trg-bjs*njg+hns-jbr-gqy+umi*ngj*cvc/arn+yej-hxw-dqg-vyb
raj=ckj-ece/mge*lut*dag+woj*jva*wgd-yon-jiw-otf*ahj/chl-sdd/oyl+dkn+lgl+arn*yej-kvq-jpu/mjk/ewc-xxt/mjt+dqg
nao=ckj/ece/ubt+fin+mge/lut-dag-woj/yon*fru*gdx*dkn*umi-cvc-kvq/mjk-kns-xxt+mjt+dqg
otf=ckj+ubt/mge+lut-sgb+woj-wgd-yon+raj+ile-chl+fru+hns/gdx/jbr-dkn*ngj*cvc/arn/hxw*kvq*onk/mjk+ewc-mjt/dqg
ahj=ece*fin-mge*lut*dag+sgb/woj*jva-wgd/trg+bjs+sdd-gdx/oyl-umi-lgl-cvc+yej-onk+jpu*mjk-xxt/vyb
ile=ubt+agq+fin/lut-sgb*jva+yon+raj/nao*fru-trg-hns*oyl/gqy+umi/lgl*yej*hxw-onk*ewc+dqg*vyb
chl=agq-wgd*yon+raj/nao/otf/ile-trg*bjs*hns/sdd-oyl*lgl-cvc-arn+yej/jpu/ewc
fru=ckj*ece*ubt/fin*dag-sgb/wgd/raj/nao+otf-ahj+chl-trg+njg+hns-mps*gdx/gqy/umi-ngj/arn/hxw-kvq/ewc
trg=ckj-agq/woj-yon/nao/ile+chl/bjs-njg/dkn*gqy+cvc-yej-hxw-kvq*onk*jpu-ewc-kns*dqg
bjs=ubt+agq+mge-lut-woj/wgd/tej/jiw/nao*chl/fru*trg*sdd+jbr/oyl+umi+lgl+kvq+onk*mjt
njg=agq/fin/lut*dag/jva+tej+yon/raj/nao+otf*ahj-ile-fru*trg-hns*gdx-jbr+umi-arn*yej/kvq-mjk-ewc-kns-dqg
hns=ece+fin*dag-sgb/jva*yon-nao/otf+ahj/ile-chl*fru-trg-mps*gdx*umi/lgl/cvc-yej/hxw/jpu+kns*mjt
mps=ckj/ece+ubt+mge*dag/woj-jiw+otf/ahj-chl/fru+trg*bjs/sdd+jbr-oyl*gqy*ngj*lgl/cvc*arn-yej+kvq/onk+jpu*ewc/xxt+mjt-vyb
sdd=agq+mge/sgb-woj-jva*tej*yon*jiw/otf/ahj+mps+jbr+ngj*lgl+yej/mjk-ewc-vyb
gdx=ckj+ece+agq*lut/dag-sgb*jva/wgd*raj*otf+ahj+ile*trg*mps/sdd-oyl/dkn+cvc-arn+yej-mjk-kns/vyb
jbr=agq*mge-dag*sgb+woj+jva-wgd/ile/chl/fru/trg*bjs+njg/mps/sdd*gdx*dkn*umi-ngj+cvc/jpu*dqg-vyb
oyl=agq-fin-mge/sgb/woj+wgd+tej+yon/otf-ile*trg+bjs+njg+mps*jbr/dkn+ngj/onk/ewc*xxt
dkn=ece+agq-mge+dag/tej/nao+otf-ahj+chl*fru*trg+bjs/njg-gdx*jbr/oyl/umi/ngj-lgl+onk-jpu*xxt*vyb
gqy=ckj-ece-woj*jva/yon+nao*ile*chl/trg+bjs/hns+jbr-oyl/umi-cvc-hxw*onk/jpu-ewc/kns/mjt*dqg
umi=agq*fin/mge/lut+dag-sgb*woj*wgd*tej-yon+otf/njg-mps*sdd*cvc+arn*yej/hxw+kns*dqg
ngj=ckj/ece+ubt+agq-mge+lut+dag/woj-jva+tej-yon/raj-otf+ahj/trg/njg-mps/sdd/gdx/jbr/gqy+lgl*cvc*arn+yej+hxw*kvq-jpu*ewc
lgl=ckj/ubt*agq-fin*lut*dag+woj+jva-yon/jiw*nao*ahj/njg/hns/gdx*jbr-dkn/gqy*umi/cvc*hxw+mjk*ewc*kns+xxt*mjt*vyb
cvc=ckj*ubt-mge*dag*sgb+woj-jva-wgd+tej/jiw+otf*trg-njg*mps*gqy-umi-ngj-lgl*yej/onk/kns-mjt+dqg+vyb
arn=ckj/ece*ubt+agq+lut*dag/woj*tej/yon-jiw-chl+trg*mps/gdx+oyl*yej+hxw/onk*mjk/ewc/dqg/vyb
yej=ckj/ubt+fin-sgb+woj+jva+tej+jiw/raj-nao+otf*ile*chl-fru-bjs/njg*mps*sdd-gdx*dkn+umi+hxw+kvq/jpu-mjk*mjt+dqg
hxw=ckj+ece+ubt*agq-fin/lut/woj/jva/tej/yon+ahj+ile*trg+njg+hns*mps-jbr/oyl*umi-cvc+kvq/jpu*mjk-ewc/kns*dqg
kvq=ckj+ece-ubt/fin+woj-jva/wgd/tej+yon+jiw*raj/ahj*chl*fru+trg-mps*jbr-gqy+hxw/mjk*ewc+mjt
onk=ckj/agq/mge+lut-dag*sgb+tej/yon/jiw*raj+nao-ile*chl-fru+hns*mps*sdd-gdx+oyl/dkn-gqy+ngj-lgl/kvq-jpu+mjk/kns+dqg
jpu=ubt/dag-woj+tej+yon/jiw/otf/ile/chl-bjs*njg+hns*sdd-gdx+umi+ngj+lgl*cvc-arn+kvq-onk*mjk*ewc+kns+xxt-dqg/vyb
mjk=agq-fin*mge+dag+sgb*woj*jva-tej-yon-jiw*raj/nao/otf+fru/njg/hns+mps/gdx+dkn/ngj/cvc/yej/kvq+jpu+ewc+kns*xxt-mjt/dqg-vyb
ewc=ckj+ece-agq*lut*sgb-yon*nao+ahj-ile/trg-bjs-njg*hns+mps+sdd*oyl*ngj*lgl/cvc+yej+onk+mjk+vyb
kns=ece+mge-lut*dag+sgb+woj/tej*yon*nao+otf*ahj/fru*trg*bjs/njg+gdx-oyl-gqy*umi*ngj+lgl+arn-vyb
xxt=ckj*ece*ubt/agq-fin*lut*dag*sgb*woj/jva*jiw+nao*otf+ahj-chl/fru/bjs*njg+sdd+oyl*gqy+umi*ngj*yej+jpu+mjt+dqg
mjt=ckj*ece-ubt+agq/fin-lut*woj*jiw/nao-ahj+fru*bjs/njg/mps+gdx-jbr/umi-ngj/yej*onk-jpu*ewc*xxt-dqg-vyb
dqg=ece/ubt+fin/mge*woj+wgd+jiw/raj-nao-ahj/ile/bjs*hns-oyl+gqy+hxw*mjk-ewc*xxt+mjt/vyb
vyb=ckj-agq-fin*mge-sgb+woj*jiw-nao+otf+ile/trg+hns+mps+sdd*jbr/ngj/lgl+cvc-yej+mjt+dqg

