50
ckj=agq-mge-lut-dag/jva*wgd-jiw+otf+ile-chl*bjs+njg-mps*sdd+jbr+gqy/umi/cvc-arn+yej+kvq/onk*kns*mjt/dqg
ece=agq*fin/lut-sgb*woj-wgd-tej-yon-jiw-nao/ahj*ile*fru+hns*gdx-oyl*dkn-gqy/ngj/lgl*cvc*onk*mjk/mjt/dqg+vyb
ubt=ckj-ece*fin-mge/dag*sgb*woj/wgd+tej+jiw+raj*nao-ahj-ile-chl+fru*mps+sdd-gdx*oyl-dkn-gqy+lgl*yej/kvq-onk+mjk+kns/xxt*dqg+vyb
agq=ece/ubt-lut/dag-woj-jva/wgd+yon-raj+ahj*ile+bjs+jbr+gqy+umi-ngj/cvc+jpu+mjk+kns
fin=ckj*ubt*agq+mge+lut/sgb/woj*jva+tej*jiw*raj*otf/ahj*ile*chl/bjs+njg+hns*mps-sdd/gdx*jbr/gqy-umi-lgl/cvc/arn*hxw-ewc*xxt-dqg
mge=agq+fin/lut*dag/sgb/woj*jva+tej-jiw-raj*otf+ile+chl+fru+njg-sdd*jbr+gqy*umi+lgl/hxw+onk/jpu+ewc-kns/xxt/dqg
lut=ece/ubt+mge-sgb+woj+tej+otf+fru+njg+gdx*jbr/oyl-dkn+gqy-ngj/lgl-kvq/mjk/kns/xxt*dqg+vyb
dag=ece*fin*mge+lut*jva-tej/raj/otf*fru/bjs*njg*mps-sdd+gdx+gqy*ngj-lgl*jpu-ewc+xxt
sgb=ubt/fin+mge*lut*woj-tej/jiw*nao+otf-ahj/ile*chl+fru/mps+sdd-gdx/dkn*gqy-umi/ngj-cvc+arn-yej/hxw+onk*jpu-ewc*kns-xxt+mjt
woj=agq-lut/dag*wgd+tej+yon-raj-chl-njg+mps+gdx*jbr+ngj*lgl+cvc*arn-yej-jpu-mjk+ewc*kns-xxt*mjt*vyb
jva=agq-fin/sgb+woj*wgd/yon-nao+ahj-chl+fru+bjs+hns*mps+sdd+gdx-jbr/dkn*ngj-lgl*arn-yej*hxw+kvq-vyb
wgd=ubt/agq/lut*dag+sgb/jva*yon+jiw*nao+otf+ile+trg-bjs+njg*hns/gdx+dkn-gqy+umi+ngj/lgl-yej/hxw*onk-jpu-mjk*dqg
tej=ckj/agq/mge/woj-jva*wgd/yon-jiw+raj+otf+ile-trg+njg-hns-oyl+dkn*ngj-cvc+arn-yej/hxw/kvq*onk/jpu/ewc*dqg
yon=ece/ubt*fin/mge*dag*sgb/woj-nao*otf-ahj-fru/trg+bjs/njg-hns*mps*jbr+gqy-umi+ngj+cvc-yej+onk-dqg
jiw=ece/fin/mge/lut-dag/woj+wgd-tej-yon*raj/otf*chl+fru*trg/hns-sdd*gdx*jbr/oyl/gqy/umi*ngj-arn*hxw*jpu/kns*dqg/vyb
raj=ckj/agq/mge*lut/sgb*jva*tej*jiw+nao*ahj-fru+trg+njg/jbr*gqy-ngj-cvc+arn/yej/jpu/mjk*kns+xxt*mjt
nao=fin-lut-woj*yon/otf+ile+trg/njg/hns*mps*sdd/oyl-umi/ngj-lgl-yej+hxw+kvq-onk*ewc/xxt+mjt-dqg-vyb
otf=ckj/agq+fin-sgb-woj/jva*jiw-nao+ile+chl+bjs+njg*mps*gdx-jbr*gqy+ngj*lgl+yej-hxw/kvq/ewc-kns-xxt+mjt-dqg
ahj=ckj*ece*ubt/agq+mge+lut-dag*sgb/woj*jva*wgd/raj-nao-otf*chl+fru*trg/bjs+njg+hns/mps/gdx*jbr+dkn-gqy/umi/lgl-cvc/yej-hxw*kvq-onk+jpu+dqg+vyb
ile=ckj+agq-lut/dag-woj+tej/yon+raj-ahj+chl+fru-trg-bjs-njg*hns*sdd/gdx/dkn/gqy-umi/cvc-yej/kvq-vyb
chl=ckj*ece+ubt*agq*lut*raj+nao/otf+ile*trg-njg/gdx*jbr/dkn-ngj-cvc*hxw/jpu-mjk*ewc-xxt+mjt
fru=ckj/lut/dag-woj-wgd-yon-jiw-ahj+ile/trg+bjs/njg-jbr/cvc/yej-jpu-ewc*xxt-mjt
trg=ckj+ece/agq+mge/lut/dag/woj-jva/yon-jiw*raj/nao/otf/ahj*ile/fru/njg+mps/gdx+oyl*dkn+gqy-umi*cvc/arn+jpu-ewc/mjt*dqg
bjs=ece*agq-lut/dag*wgd*yon-jiw/raj/ile+trg/njg+hns+mps/gdx+oyl/dkn-gqy/lgl+cvc-arn-yej-jpu-mjk+kns/mjt
njg=ckj*fin/lut*dag-jva-wgd-yon-jiw*raj*nao+ahj+mps+sdd+gdx*oyl+dkn+gqy/cvc*kvq+jpu/ewc/xxt
hns=ubt-agq*fin/lut*dag*sgb+wgd+tej-yon/raj-ile+chl*fru+trg+sdd/jbr+oyl/dkn*gqy+umi/arn/hxw/mjk-kns/xxt+dqg*vyb
mps=ckj*ece*ubt-fin-dag+sgb/jva/yon-jiw*raj*otf*ile/trg/njg-hns-sdd/gdx/jbr*oyl/dkn+gqy*cvc/arn/yej/hxw*kvq/onk*jpu/mjk+xxt/dqg*vyb
sdd=ckj*lut+sgb+woj-jva+tej-raj-otf-ahj/ile/chl/trg-bjs-gdx*dkn/umi+arn/hxw-onk/jpu/kns+xxt+mjt*vyb
gdx=ckj+ece-ubt/agq+fin+sgb-jva*wgd+tej*jiw*ile-njg-sdd*oyl-dkn+gqy-lgl/cvc-arn+hxw-kvq-onk/jpu/mjk+xxt+mjt
jbr=fin/mge+lut-dag/sgb/woj/wgd*otf-ahj*trg/njg+hns*mps*sdd-dkn/gqy-ngj*cvc-kvq/jpu*xxt+mjt
oyl=ece/fin+lut+dag-sgb+tej-otf-fru/njg+mps+gqy/umi-ngj+lgl-hxw*kvq*onk*jpu+ewc-dqg*vyb
dkn=ckj-ece+agq-sgb-jva*yon-jiw-raj-nao+otf+ahj*fru/trg/hns*oyl*gqy*umi-cvc*kvq/onk-jpu*mjk+mjt
gqy=ckj*ece-ubt+agq/fin-mge*lut/dag-sgb-wgd+tej+raj*otf/ahj-ile-fru*bjs-njg+hns*sdd*gdx+jbr*umi+ngj+cvc+kvq*onk/mjk*ewc*xxt-vyb
umi=mge/dag/sgb*jva/jiw/raj*ile*mps+dkn*gqy*lgl-kvq*onk/jpu*mjk+ewc/xxt/dqg
ngj=ece*agq/lut*dag/jiw-raj-ahj*fru/trg/bjs+hns/gdx+jbr/dkn+umi-lgl/cvc/arn*yej/kvq*onk*jpu+mjk-kns-xxt-vyb
lgl=ckj*ece+agq/fin-mge/dag-sgb-woj*tej+jiw-raj/otf+chl*trg/hns-jbr*dkn*gqy/ngj-cvc/arn-yej*kvq/onk*jpu+ewc
cvc=ece-agq/mge/sgb*woj*jva*otf/chl-trg*bjs-gdx-dkn*gqy*umi+arn-jpu/mjk*ewc/mjt*dqg+vyb
arn=ckj*ece+ubt-agq*jva/wgd*tej+jiw/otf*ahj*trg*hns+sdd+gdx+oyl*dkn+gqy/ngj+lgl*cvc+mjk+xxt+mjt-dqg
yej=ubt*agq-fin+sgb+jva+wgd/raj*otf/fru-trg-njg+hns-mps/sdd/ngj/cvc-mjk+ewc-xxt+vyb
hxw=ece/mge/sgb-wgd*yon-nao-otf+fru/bjs*hns/sdd/jbr+oyl+dkn-gqy*lgl+jpu*kns+xxt+dqg/vyb
kvq=ubt-agq*fin-mge*dag+sgb-wgd+tej/yon-nao/ahj+trg/hns/mps/gdx+dkn-ngj*yej/hxw*jpu-mjk*ewc*xxt+dqg
onk=ece+ubt*agq-mge/lut/sgb-woj/jva+tej*raj-otf*chl*trg*bjs/sdd*jbr+oyl+dkn*gqy-umi-yej-kvq+xxt+vyb
jpu=ckj-sgb/woj/jva+tej+raj*nao-otf-ile-chl+trg+njg+mps-sdd*gdx+oyl/dkn-yej-hxw+onk*mjt+dqg
mjk=ckj+ece*ubt/fin/dag+jva-wgd*tej+yon+jiw-raj*ile+trg/bjs+mps-umi+lgl*cvc/yej-jpu/ewc-mjt*dqg+vyb
ewc=ece*fin/lut-dag/sgb-woj/jiw*raj*fru/trg+njg*hns-mps/gdx/jbr-oyl*umi-hxw-onk/kns/mjt/dqg
kns=ckj+mge/sgb-wgd*raj*fru-hns*gdx/jbr-dkn+umi/yej-hxw*kvq-onk*ewc*dqg
xxt=ckj*fin-dag+sgb/woj/jva/wgd/yon+raj/ile-chl*trg/mps*sdd/gdx-jbr*oyl*gqy+ngj/lgl*jpu/dqg*vyb
mjt=fin-mge*dag-sgb+jva*yon/jiw+ahj+njg/mps-sdd+jbr/dkn*ngj-lgl-cvc/yej+jpu-mjk+ewc*xxt*dqg
dqg=fin+sgb-woj*tej+yon/jiw/otf/ahj*ile-chl+fru+hns+mps-sdd/gdx/umi-lgl-arn/yej-hxw+onk/vyb
vyb=ubt-dag-sgb*nao/ahj+fru-bjs+njg-mps-sdd+oyl*dkn/umi*ngj+cvc+arn-yej-hxw+kvq/mjk+ewc+xxt/mjt

