arn=agq/fin*dag*woj/tej+hns-dkn/umi/yej/kvq*mjk/dqg+vyb
bjs=agq-dag/woj+jiw-hns-umi/cvc+yej+mjk*dqg
ckj=agq-fin*ile-fru*cvc*yej/dqg
ewc=fin-woj/jiw-fru+hns/umi+yej/kvq-onk*mjt*dqg/vyb
gqy=fin-dag-woj/dkn/yej/onk/mjt
jbr=agq/dag/tej-dkn*umi-yej-kvq+onk-dqg
jva=agq-fin*dag+tej+jiw+ile*fru/hns*umi*yej-kvq*onk-mjk/mjt+dqg-vyb
lgl=agq-dag*woj*tej/jiw-dkn-umi/cvc*onk-mjk
lut=fin-dag*tej-jiw*ile-hns/umi/cvc-kvq*onk*mjt
mge=dag*tej/jiw*ile/dkn-umi+cvc-yej*onk+mjt+vyb
ece=ckj+fin-mge*dag+tej*ile+fru-bjs/hns+jbr+umi/lgl+cvc*yej+kvq*onk+ewc-dqg
nao=agq/dag-tej*jiw/dkn+cvc/onk+dqg
ahj=agq*lut+woj*tej+nao+ile+fru+bjs*hns*jbr/dkn+gqy*lgl/yej+kvq*mjt-dqg-vyb
chl=ckj+woj/jva-tej-jiw/nao/fru/gqy+umi*lgl/mjt
gdx=ckj-fin*mge*dag-woj+jva*tej/jiw/nao/fru/hns/dkn-cvc/arn+yej-kvq/onk/dqg-vyb
hxw=agq*fin*dag+woj-jva-jiw*nao*ile/fru*bjs+gqy-lgl*cvc/arn/yej*kvq-mjk/dqg
ngj=ckj*fin/mge+lut*dag/tej/jiw+nao/ile+bjs*hns-dkn+gqy/umi-cvc*yej-mjk-vyb
otf=woj*hns/dkn+umi-yej*dqg
jpu=ckj/lut*dag/tej-jiw*nao/otf+ile-hns-jbr-dkn-kvq/ewc+mjt+dqg/vyb
kns=ckj+fin+mge+lut/dag-woj/jva+otf*fru-bjs/umi/cvc-arn+yej+kvq/mjt
njg=ckj*fin/mge+lut*dag/jva*tej+jiw+nao/otf+ile+hns*jbr*gqy/umi+lgl*arn-yej/onk/ewc/mjt
oyl=ckj/fin+lut+jva*jiw*otf*bjs*hns/jbr*dkn+cvc+arn+kvq-ewc+mjt-dqg/vyb
sdd=agq/lut*dag/jva-tej-jiw*nao+otf/ile/bjs*jbr-dkn+umi+lgl+arn-kvq-mjt+dqg+vyb
sgb=agq*dag-umi-cvc*kvq-onk/dqg/vyb
mps=ckj/agq-fin+lut+sgb+jva/nao*otf*jbr*umi-cvc*onk*ewc+mjt+dqg
raj=agq-dag/sgb*woj+jiw-otf-fru-jbr+gqy/umi-lgl-cvc-mjk/mjt+vyb
trg=ckj*mge/dag-sgb+woj+nao*otf+fru*dkn+gqy+lgl/cvc-arn+mjk/ewc+mjt*vyb
ubt=mge*lut*nao*ile-umi/lgl-cvc+arn-yej*mjk/ewc-dqg+vyb
wgd=ckj*fin*woj/jiw/ile-fru/gqy/cvc/yej+kvq*onk+mjk-dqg-vyb
xxt=fin+lut/sgb+jva/tej+nao*hns/jbr*lgl/cvc+arn-mjk+ewc
yon=ckj*agq/fin-lut*sgb/woj/tej-bjs+hns+jbr-dkn-umi/cvc*arn*onk/mjt


