arn=woj/otf+dkn*hxw+ewc+xxt+vyb
dqg=ece/otf/ewc*kns+xxt-vyb
ngj=woj*wgd*jiw*nao-otf/oyl*hxw-kvq*ewc*kns+mjt-vyb
sdd=woj-jva-nao*otf-gdx*oyl*hxw/kvq/kns*mjt
sgb=woj/jva-jiw/dkn/ewc-mjt+vyb
fin=sgb*woj-wgd/jiw+arn+ewc/kns-dqg
ile=sgb-woj+jva/wgd/nao/otf-sdd+gdx-oyl*dkn*ngj/kns+mjt
jpu=ece/sgb+woj*wgd/jiw*nao-gdx-oyl/dkn+kvq/ewc*mjt+dqg-vyb
onk=ece*sgb+dkn-ngj-arn*ewc*kns-mjt*vyb
ubt=woj/jiw+otf/gdx/oyl/hxw/ewc*kns-xxt-vyb
lut=ece/ubt*sgb*jva-nao/ile*sdd-gdx-ngj/arn/ewc+kns-vyb
raj=ubt+sgb/jva+jiw/nao-otf+sdd/gdx*oyl/ngj-ewc/xxt-dqg
jbr=ece+fin+raj-ile*oyl/dkn*hxw+kvq*jpu-kns+mjt
mge=ubt+woj/jiw/raj/nao+ile-sdd/dkn/ngj+arn/hxw/onk-jpu/ewc-kns*mjt+vyb
mjk=ubt*sgb-woj*raj*nao+otf+sdd/gdx*hxw/onk/jpu/mjt
umi=sgb/woj+jiw*otf/sdd*ngj+arn+ewc-kns+xxt/mjt*dqg
ckj=fin-sgb*raj+ile/oyl+dkn*umi/arn-hxw/kvq/onk+ewc*xxt+mjt+dqg
cvc=ece+ubt*fin*woj-wgd+jiw+nao/ile+gdx*umi/ngj-arn/hxw*jpu-kns+mjt
fru=fin*sgb+woj/jiw*ile+gdx+dkn-umi-ngj*kvq*onk-jpu*xxt*mjt*dqg-vyb
hns=ece+fin+woj-jiw+raj*otf*sdd-gdx*oyl/dkn+umi-arn+hxw-kvq+onk+jpu*ewc*dqg
yej=ece/woj*wgd-jiw-otf-sdd+dkn*arn-hxw+ewc/xxt-mjt-dqg
agq=ece+fin/sgb/wgd*raj*otf*ile*oyl*umi+ngj/arn-yej-hxw/onk+jpu*mjt+dqg
ahj=ece/fin+sgb*woj+jva-wgd*otf/ile*gdx-arn+yej*hxw-kvq-onk-jpu+ewc-kns/xxt*mjt
bjs=ece+ubt-woj+jva*jiw-nao-oyl/umi-ngj/arn-yej-kvq+mjt+vyb
chl=ece-ubt-sgb-woj+jva-wgd-oyl+arn/yej*kvq+onk/ewc+kns
dag=fin-jva/jiw*nao+ile/gdx*oyl*umi-ngj+arn-yej/hxw*kns*dqg+vyb
gqy=ece+fin-woj*jva-raj+otf+ile/oyl/arn+yej*kvq+jpu*ewc+xxt*mjt*vyb
lgl=ubt/woj+wgd/raj/nao-ile*sdd-gdx-oyl-dkn*umi*ngj*yej*kvq+kns
mps=ubt+sgb+woj/jva+wgd/jiw*raj-otf+dkn-umi/ngj+arn/yej-hxw+kvq-kns*xxt*mjt/dqg+vyb
njg=woj/raj+nao*dkn+umi*yej+kvq*jpu*ewc-kns
tej=ece/ubt-jva+wgd+jiw-raj/otf/ile-sdd/gdx/oyl/dkn+arn*yej*onk+ewc+xxt/mjt-dqg
trg=ece*fin*jva+wgd+nao/otf-oyl+dkn/umi+arn/yej-onk-jpu-ewc*kns+dqg
yon=ece-ubt/sgb/wgd-otf+oyl/yej+onk+jpu/ewc
