bjs=woj*yon-otf+sdd-hxw+onk
cvc=mps*sdd+gqy+hxw-onk
dag=woj/yon*otf+sdd*gqy
ile=agq/yon-mps+sdd/gdx+xxt
jpu=woj*yon/gqy/hxw
jva=yon-gqy/xxt-mjt
ngj=lut/woj*yon/otf/mps/sdd-gdx+onk/xxt/mjt
njg=mps-sdd/gdx/gqy+onk/xxt*mjt
tej=agq*yon+otf-mps/sdd*gdx+gqy*onk*xxt-mjt
fru=lut-dag-tej+yon-otf+ile/bjs*mps-gdx/hxw-mjt
trg=woj/yon*otf/mps*sdd-gqy/hxw*xxt
ubt=agq*lut*yon+mps-gqy+hxw-mjt
chl=ubt+dag*jva*yon-otf*ile-sdd-cvc-hxw/mjt
ewc=ubt+agq*lut/dag-woj/jva-yon/otf*gqy+jpu+mjt
umi=woj/yon-mps/sdd*onk*xxt-mjt
ckj=lut*dag-jva-otf-ile*mps*gqy-umi/ngj+cvc-jpu+xxt
hns=agq-woj/tej*yon/otf/mps/gqy/umi/hxw-onk+jpu+mjt
raj=ckj+agq+dag*woj+jva/chl*fru+bjs+njg-hns*sdd-gdx/ngj/jpu-ewc-xxt
sgb=lut-jva-yon*ile-trg+njg-mps-gdx*umi+cvc-jpu-xxt
dkn=lut-sgb-woj-jva+tej-otf+chl+bjs-njg*hns/ngj+onk*jpu*ewc
vyb=agq*dag*tej-yon*otf*trg*mps*sdd+gdx+cvc/hxw+mjt
jbr=ckj-agq+lut+jva-tej+chl-trg+hns/umi*cvc*hxw-jpu/xxt*vyb
oyl=dag+sgb*tej+fru-njg-mps-umi+onk*jpu*mjt-vyb
yej=dag-yon/ile+bjs-mps-gqy-cvc-xxt
ece=ubt*agq*dag*woj/tej-otf+ile-fru+trg+bjs+njg/ngj-yej+onk+xxt/mjt
kvq=ubt+agq*dag+sgb*woj*tej-chl*bjs-njg+gdx*umi*yej+jpu/ewc*vyb
ahj=agq+lut+dag-sgb/jva/yon+otf*chl+fru-bjs-njg*hns*gdx-gqy/umi+kvq-ewc*xxt
arn=ubt*dag-woj+tej*yon*chl-fru/trg/bjs/njg+hns/sdd/oyl+dkn*umi-cvc*hxw*kvq*ewc/xxt*mjt
dqg=ckj-ece/sgb+jva-tej-yon-raj*ile*trg*mps*oyl+dkn*umi+kvq/jpu*ewc/xxt-mjt
fin=ckj+ece*lut*dag-sgb+woj-ile+chl/fru+trg+hns*jbr/oyl-dkn+umi*ngj/hxw/kvq-xxt
jiw=ece/agq+dag/sgb*woj+jva+ile*chl-fru-trg+bjs-njg-sdd-oyl/dkn*kvq-onk*jpu+mjt
kns=agq+lut/tej/yon/raj*otf*ile+trg-hns/mps-sdd/gdx*cvc/hxw+kvq*onk*ewc*xxt
lgl=agq-sgb*woj+tej*raj+chl-trg*njg/hns-sdd/dkn*gqy-umi-hxw+kvq-vyb
mge=ece+jva-ile/fru-njg+sdd+gdx/oyl/dkn-umi/ngj-hxw*kvq+onk+ewc*mjt
mjk=ece-agq*lut/sgb-raj+otf+ile-chl*fru-trg/njg/mps/ngj+cvc/yej*onk+jpu-xxt/mjt-vyb
nao=ckj-ece-agq*lut+dag+sgb*woj*raj/otf/fru-njg*hns*mps/dkn/cvc+hxw-xxt+vyb
wgd=ckj+ece-agq/lut-woj/raj-otf+chl/fru+trg+njg/mps*sdd+gdx+jbr*ngj/cvc/hxw/kvq+jpu/ewc


