cvc=otf/ngj
dqg=fin/hns/ngj
jbr=otf-hns*ewc
jiw=fin-hns*yej*ewc
kvq=otf/ngj
ahj=jiw*otf*jbr+kvq*ewc
gqy=otf*yej/kvq*dqg
mge=otf/kvq-ewc
mjk=fin/jiw+otf/hns*ngj/kvq-ewc*dqg
oyl=fin*yon
bjs=yon+jiw*jbr*oyl+yej+kvq
dkn=yon-jbr*oyl/cvc-yej*dqg
fru=fin+otf*hns*jbr/oyl*yej/kvq+ewc
ile=fin-jbr-oyl*yej*kvq-ewc*dqg
jpu=fin/yon-jiw+otf+oyl/ngj-cvc-kvq
jva=yon/otf/oyl+cvc-yej+dqg
lut=yon/jbr+oyl+ngj*cvc*yej+kvq-ewc+dqg
nao=fin*otf-hns*jbr-oyl-kvq-ewc/dqg
agq=fin-jva+nao/ahj*bjs-hns*oyl+cvc/yej/jpu*ewc/dqg
tej=fin+otf-hns*ngj+kvq/dqg
gdx=lut*jva*tej+ahj*bjs+jbr/oyl*dkn+ngj*cvc+yej*jpu/ewc*dqg
vyb=yon/jiw+jbr*oyl*yej*dqg
woj=yon-otf+cvc/kvq-dqg
lgl=fin/lut+woj/jva+nao*otf*ahj*ile*bjs/hns+jbr/oyl/dkn+gqy+ngj-yej+kvq-dqg/vyb
sdd=fin+mge/woj-jva+tej+nao/otf*ahj/hns+dkn*ngj*lgl/cvc/yej*jpu-mjk+ewc*dqg-vyb
wgd=fin*mge-woj+tej/yon*bjs-gdx*jbr*oyl+dkn/gqy-lgl+kvq*jpu*mjk+ewc+dqg
xxt=fin+jiw/hns-jbr*oyl*cvc+kvq*ewc-dqg
ckj=fin*lut/tej*nao+fru*bjs/oyl-dkn-gqy/ngj/yej*kvq-jpu+xxt/vyb
njg=fin*jva/tej+jiw*nao*ile+fru+bjs*hns+jbr*dkn-ngj*cvc*jpu-mjk/xxt+dqg
mps=agq-fin+lut/woj*jva-nao+otf-ahj-ile*bjs/njg+hns-gdx/dkn-gqy/lgl*cvc-jpu*xxt
onk=agq*fin-lut*jva/tej/yon+jiw/otf/ahj+ile/fru*bjs*gdx+jbr*dkn+ngj*lgl+yej+kvq-mjk-xxt*dqg
sgb=agq-mge+woj+jva-tej*otf/gdx*oyl+dkn-kvq+xxt/dqg*vyb
trg=lut/nao+ahj+ile/hns+dkn*mjk+xxt+vyb
arn=ckj*agq-fin*woj-nao-otf/ahj-trg-hns-oyl*gqy-lgl/yej*kvq+jpu+mjk+dqg*vyb
chl=agq-mge+jva-yon+jiw+nao*otf-ahj+trg-bjs+hns*gdx-jbr/oyl+dkn+cvc*kvq*jpu*mjk-xxt*dqg
dag=agq*woj-tej/yon+nao-otf-ahj*fru*trg+bjs/gdx+gqy/ngj/lgl/jpu*ewc/dqg*vyb
ece=ckj+agq+fin/mge+lut/jva+yon/jiw-nao+otf/ile/trg/gdx*jbr*gqy+cvc-yej+kvq*jpu/mjk+ewc+xxt+dqg-vyb
hxw=agq+mge*lut*jva+tej-yon+nao*otf/ile/fru+trg*bjs-hns/oyl+dkn*lgl/cvc+kvq*xxt+dqg+vyb
kns=agq/fin*woj/jva+tej-yon+trg/bjs/hns+gdx*jbr-oyl/gqy*ngj/yej/mjk*ewc*xxt
mjt=ckj+fin/lut-jva+tej/jiw-nao/otf*ile-trg-hns*gdx-oyl+lgl/ewc-dqg+vyb
raj=agq+mge/lut+woj*jva+yon*jiw/otf+ahj/ile+trg*bjs/njg*hns*gdx*jbr*oyl-gqy+lgl/yej+ewc*xxt-vyb
ubt=ckj+mge-lut+jva+yon/jiw+fru+trg-njg+hns+gdx+dkn+ngj*lgl*ewc+xxt
umi=agq-fin/mge+jva+yon-nao+ahj*ile+fru/trg-hns*oyl*cvc*yej-xxt


