ahj=ckj/ece*lut+dag*yon-raj+gqy/kvq*ewc
arn=ckj/ece+agq+mge*dag*sgb/wgd/raj-njg/mps-gqy
dqg=ece/agq-lut*wgd/yon+raj+njg/umi/kvq
hns=ckj/agq-mge*lut/raj*bjs*njg-gqy+ewc
hxw=mge/lut*sgb/wgd/bjs+njg+ewc
jbr=ece+agq*lut*mps+kvq-ewc
jpu=ckj-mge/lut/sgb-wgd/yon/bjs/njg/mps/gqy
ngj=ckj*ece-lut-dag+sgb-yon+raj+bjs-njg+mps/gqy
onk=ckj-ece-mge-sgb-wgd*yon/raj/bjs-gqy/umi+ewc
jiw=mge*lut*wgd-raj/njg-gqy*ngj-arn/hxw+onk+jpu
oyl=ece/mge-raj-bjs+gqy-umi+ewc
gdx=ckj/ece-lut-yon/ahj*bjs-mps/jbr-oyl+gqy*umi/hxw+onk
tej=ckj+ece-agq*mge*lut+wgd/yon-raj*bjs/njg-mps/gqy+umi+kvq+ewc
mjt=ece/lut-sgb-wgd-tej+yon/raj/ahj+njg+hns-jbr*umi-kvq/onk
ubt=wgd+tej-bjs+njg/mps+jbr/gqy-ngj*hxw*kvq+onk*jpu-dqg
woj=ckj/ece*agq/mge/lut*yon*raj*bjs-gqy+kvq/ewc
chl=lut/dag-woj+wgd+tej/raj*ahj*njg-mps/jbr/oyl/gqy-arn+hxw/onk/jpu-dqg
dkn=mge+lut*dag*woj+wgd/raj+njg-hns+mps*gqy-hxw/ewc*dqg
fru=lut*dag/woj*tej+yon+bjs/jbr+oyl*umi/ngj-arn-onk+jpu-ewc/dqg
lgl=ckj/ece/agq*mge-dag*woj*tej-hns-oyl*gqy*umi*ngj*arn*hxw+onk/jpu/ewc+dqg
sdd=ckj-ece-agq/mge/dag*sgb+woj+wgd-tej-mps-jbr*oyl-arn-hxw*dqg
xxt=agq/mge*dag*sgb/wgd+gqy+ewc
cvc=agq-lut*dag*sgb-woj+wgd-tej/yon-raj+ahj*bjs-jbr*gqy+ngj+kvq-xxt
fin=ckj+mge-lut-dag-wgd*yon+ahj*bjs*hns/oyl+gqy*umi/ngj*hxw*onk+xxt
ile=ckj/agq*mge/wgd/tej+yon/raj*ahj*njg/oyl*gqy+umi/jpu-ewc-xxt
jva=ckj+ece*mge/lut+sgb/wgd*raj/ahj+bjs-njg*oyl+umi/arn-kvq-jpu/ewc/xxt+dqg
kns=ckj/dag+sgb*woj-wgd/tej/ahj/hns*jbr*oyl-gqy+ngj-arn+kvq-jpu+xxt
mjk=ece+agq+lut*dag-sgb*wgd*tej/raj-gqy/umi-ngj-arn-ewc-xxt
nao=ckj*dag/sgb/tej-yon-raj-ahj*bjs-hns*mps+umi+ngj*arn-jpu-ewc+xxt
otf=ckj/ece/agq/tej*ahj/bjs-mps*gqy*umi*ngj*hxw-kvq+ewc*xxt
trg=ckj/lut/woj+raj-bjs/njg/mps/jbr-oyl*umi*arn+kvq/onk*ewc+xxt/dqg
vyb=mge+lut-sgb*raj/bjs-umi/arn*onk+jpu*ewc+xxt+dqg
yej=ckj/agq-lut*dag/woj*wgd+tej*bjs-njg*gqy+ngj+arn*onk+jpu*xxt-dqg
